TEAM_ID,TEAM_ABBREVIATION,TEAM_NAME,GP,W,L,MIN,OREB,OREB_CONTEST,OREB_UNCONTEST,OREB_CONTEST_PCT,OREB_CHANCES,OREB_CHANCE_PCT,OREB_CHANCE_DEFER,OREB_CHANCE_PCT_ADJ,AVG_OREB_DIST,DREB,DREB_CONTEST,DREB_UNCONTEST,DREB_CONTEST_PCT,DREB_CHANCES,DREB_CHANCE_PCT,DREB_CHANCE_DEFER,DREB_CHANCE_PCT_ADJ,AVG_DREB_DIST,REB,REB_CONTEST,REB_UNCONTEST,REB_CONTEST_PCT,REB_CHANCES,REB_CHANCE_PCT,REB_CHANCE_DEFER,REB_CHANCE_PCT_ADJ,AVG_REB_DIST,SEASON,MEASURE_TYPE
1610612737,ATL,Atlanta Hawks,81,38,43,18426.0,705,398,296,0.565,2192,0.322,73,0.333,8.0,2540,730,1792,0.287,4619,0.55,421,0.605,6.4,3245,1128,2088,0.348,6811,0.476,494,0.514,6.7,2013-14,Rebounding
1610612738,BOS,Boston Celtics,82,25,57,18846.0,980,582,371,0.594,2668,0.367,86,0.38,7.5,2505,677,1822,0.27,4573,0.548,386,0.598,6.2,3485,1259,2193,0.361,7241,0.481,472,0.515,6.5,2013-14,Rebounding
1610612751,BKN,Brooklyn Nets,81,43,38,18374.0,709,391,301,0.551,1981,0.358,70,0.371,8.2,2378,675,1689,0.284,4318,0.551,354,0.6,6.6,3087,1066,1990,0.345,6299,0.49,424,0.525,7.0,2013-14,Rebounding
1610612766,CHA,Charlotte Bobcats,81,42,39,18727.0,766,416,340,0.543,2240,0.342,52,0.35,8.3,2689,748,1933,0.278,4912,0.547,442,0.602,6.3,3455,1164,2273,0.337,7152,0.483,494,0.519,6.7,2013-14,Rebounding
1610612741,CHI,Chicago Bulls,82,48,34,19159.0,937,533,384,0.569,2690,0.348,94,0.361,7.9,2680,788,1882,0.294,4935,0.543,425,0.594,6.3,3617,1321,2266,0.365,7625,0.474,519,0.509,6.7,2013-14,Rebounding
1610612739,CLE,Cleveland Cavaliers,82,33,49,18810.0,987,547,427,0.554,2912,0.339,74,0.348,8.0,2629,734,1883,0.279,4826,0.545,398,0.594,6.6,3616,1281,2310,0.354,7738,0.467,472,0.498,6.9,2013-14,Rebounding
1610612742,DAL,Dallas Mavericks,82,49,33,18896.0,839,488,346,0.582,2217,0.378,75,0.392,8.0,2513,739,1761,0.294,4515,0.557,407,0.612,6.4,3352,1227,2107,0.366,6732,0.498,482,0.536,6.8,2013-14,Rebounding
1610612743,DEN,Denver Nuggets,82,36,46,18945.0,1007,574,397,0.57,2932,0.343,99,0.355,7.8,2717,747,1974,0.275,4968,0.547,462,0.603,6.4,3724,1321,2371,0.355,7900,0.471,561,0.507,6.8,2013-14,Rebounding
1610612765,DET,Detroit Pistons,82,29,53,18453.0,1195,738,420,0.618,2979,0.401,105,0.416,7.0,2524,772,1750,0.306,4431,0.57,388,0.624,6.1,3719,1510,2170,0.406,7410,0.502,493,0.538,6.4,2013-14,Rebounding
1610612744,GSW,Golden State Warriors,81,50,31,18890.0,885,499,367,0.564,2360,0.375,85,0.389,7.8,2796,794,1980,0.284,5011,0.558,456,0.614,6.2,3681,1293,2347,0.351,7371,0.499,541,0.539,6.6,2013-14,Rebounding
1610612745,HOU,Houston Rockets,82,54,28,19094.0,919,498,393,0.542,2606,0.353,83,0.364,7.8,2796,818,1967,0.293,5033,0.556,446,0.61,6.5,3715,1316,2360,0.354,7639,0.486,529,0.523,6.8,2013-14,Rebounding
1610612754,IND,Indiana Pacers,82,56,26,18980.0,833,492,326,0.591,2548,0.327,74,0.337,7.8,2829,720,2091,0.255,5139,0.55,437,0.602,6.1,3662,1212,2417,0.331,7687,0.476,511,0.51,6.5,2013-14,Rebounding
1610612746,LAC,Los Angeles Clippers,82,57,25,18494.0,856,465,368,0.543,2206,0.388,88,0.404,8.4,2666,745,1914,0.279,4775,0.558,350,0.602,6.6,3522,1210,2282,0.344,6981,0.505,438,0.538,7.0,2013-14,Rebounding
1610612747,LAL,Los Angeles Lakers,82,27,55,18638.0,743,406,327,0.546,2188,0.34,69,0.351,8.3,2619,710,1902,0.271,4834,0.542,358,0.585,6.6,3362,1116,2229,0.332,7022,0.479,427,0.51,7.0,2013-14,Rebounding
1610612763,MEM,Memphis Grizzlies,82,50,32,18809.0,950,543,387,0.572,2669,0.356,94,0.369,7.3,2525,756,1759,0.299,4449,0.568,408,0.625,6.1,3475,1299,2146,0.374,7118,0.488,502,0.525,6.4,2013-14,Rebounding
1610612748,MIA,Miami Heat,82,54,28,18638.0,624,345,265,0.553,1766,0.353,46,0.363,8.6,2397,629,1759,0.262,4560,0.526,390,0.575,6.8,3021,974,2024,0.322,6326,0.478,436,0.513,7.1,2013-14,Rebounding
1610612749,MIL,Milwaukee Bucks,81,15,66,18537.0,963,563,386,0.585,2528,0.381,98,0.396,7.5,2365,685,1665,0.29,4415,0.536,341,0.581,6.3,3328,1248,2051,0.375,6943,0.479,439,0.512,6.7,2013-14,Rebounding
1610612750,MIN,Minnesota Timberwolves,82,40,42,18741.0,1023,630,369,0.616,2904,0.352,84,0.363,7.2,2644,811,1816,0.307,4442,0.595,365,0.649,5.9,3667,1441,2185,0.393,7346,0.499,449,0.532,6.3,2013-14,Rebounding
1610612740,NOP,New Orleans Pelicans,82,34,48,18546.0,932,508,402,0.545,2490,0.374,90,0.388,7.8,2486,715,1767,0.288,4382,0.567,379,0.621,6.5,3418,1223,2169,0.358,6872,0.497,469,0.534,6.8,2013-14,Rebounding
1610612752,NYK,New York Knicks,82,37,45,18677.0,867,494,354,0.57,2332,0.372,86,0.386,8.4,2436,659,1772,0.271,4321,0.564,346,0.613,6.4,3303,1153,2126,0.349,6653,0.496,432,0.531,6.9,2013-14,Rebounding
1610612760,OKC,Oklahoma City Thunder,82,59,23,19081.0,886,514,358,0.58,2386,0.371,81,0.384,7.5,2781,777,1990,0.279,4945,0.562,458,0.62,6.3,3667,1291,2348,0.352,7331,0.5,539,0.54,6.6,2013-14,Rebounding
1610612753,ORL,Orlando Magic,82,23,59,18811.0,793,466,309,0.588,2191,0.362,66,0.373,7.7,2653,719,1926,0.271,4803,0.552,427,0.606,6.4,3446,1185,2235,0.344,6994,0.493,493,0.53,6.7,2013-14,Rebounding
1610612755,PHI,Philadelphia 76ers,82,19,63,19093.0,948,523,397,0.552,2890,0.328,105,0.34,7.4,2556,677,1870,0.265,4670,0.547,382,0.596,6.3,3504,1200,2267,0.342,7560,0.463,487,0.495,6.6,2013-14,Rebounding
1610612756,PHX,Phoenix Suns,82,48,34,19039.0,926,518,392,0.559,2462,0.376,109,0.394,8.0,2600,711,1856,0.273,4676,0.556,381,0.605,6.3,3526,1229,2248,0.349,7138,0.494,490,0.53,6.7,2013-14,Rebounding
1610612757,POR,Portland Trail Blazers,82,54,28,18874.0,1020,596,409,0.584,2876,0.355,96,0.367,7.6,2786,768,2009,0.276,5206,0.535,493,0.591,6.1,3806,1364,2418,0.358,8082,0.471,589,0.508,6.5,2013-14,Rebounding
1610612758,SAC,Sacramento Kings,81,28,53,18562.0,978,547,396,0.559,2823,0.346,118,0.362,7.8,2627,653,1951,0.249,4748,0.553,460,0.613,6.5,3605,1200,2347,0.333,7571,0.476,578,0.516,6.8,2013-14,Rebounding
1610612759,SAS,San Antonio Spurs,82,62,20,18721.0,760,437,309,0.575,2152,0.353,64,0.364,7.8,2786,829,1958,0.298,4991,0.558,439,0.612,6.2,3546,1266,2267,0.357,7143,0.496,503,0.534,6.5,2013-14,Rebounding
1610612761,TOR,Toronto Raptors,81,47,34,18743.0,916,571,322,0.623,2709,0.338,82,0.349,7.0,2509,724,1771,0.289,4669,0.537,392,0.587,6.1,3425,1295,2093,0.378,7378,0.464,474,0.496,6.4,2013-14,Rebounding
1610612762,UTA,Utah Jazz,82,25,57,18605.0,902,535,352,0.593,2408,0.375,74,0.386,7.5,2475,672,1795,0.272,4475,0.553,388,0.606,6.5,3377,1207,2147,0.357,6883,0.491,462,0.526,6.8,2013-14,Rebounding
1610612764,WAS,Washington Wizards,81,44,37,19170.0,878,449,411,0.511,2609,0.337,127,0.354,8.8,2544,640,1899,0.252,4666,0.545,430,0.601,6.5,3422,1089,2310,0.318,7275,0.47,557,0.509,7.1,2013-14,Rebounding
1610612737,ATL,Atlanta Hawks,82,60,22,18904.0,715,415,298,0.58,1975,0.362,63,0.374,8.3,2611,763,1832,0.292,4665,0.56,350,0.605,6.4,3326,1178,2130,0.354,6640,0.501,413,0.534,6.8,2014-15,Rebounding
1610612738,BOS,Boston Celtics,82,40,42,19137.0,910,519,378,0.57,2563,0.355,86,0.367,7.8,2683,730,1939,0.272,4626,0.58,410,0.636,6.1,3593,1249,2317,0.348,7189,0.5,496,0.537,6.5,2014-15,Rebounding
1610612751,BKN,Brooklyn Nets,82,38,44,19122.0,844,528,295,0.626,2162,0.39,59,0.401,7.4,2626,674,1944,0.257,4407,0.596,340,0.646,6.7,3470,1202,2239,0.346,6569,0.528,399,0.562,6.9,2014-15,Rebounding
1610612766,CHA,Charlotte Hornets,82,33,49,19004.0,820,469,335,0.572,2337,0.351,80,0.363,8.6,2792,696,2088,0.249,4819,0.579,419,0.635,6.0,3612,1165,2423,0.323,7156,0.505,499,0.543,6.6,2014-15,Rebounding
1610612741,CHI,Chicago Bulls,82,50,32,19008.0,959,595,337,0.62,2573,0.373,83,0.385,7.1,2792,838,1942,0.3,4969,0.562,407,0.612,6.2,3751,1433,2279,0.382,7542,0.497,490,0.532,6.5,2014-15,Rebounding
1610612739,CLE,Cleveland Cavaliers,81,53,28,18466.0,900,524,356,0.582,2480,0.363,80,0.375,7.9,2585,750,1832,0.29,4439,0.582,313,0.627,6.3,3485,1274,2188,0.366,6919,0.504,393,0.534,6.7,2014-15,Rebounding
1610612742,DAL,Dallas Mavericks,82,50,32,18229.0,856,499,340,0.583,2202,0.389,88,0.405,7.4,2608,749,1850,0.287,4519,0.577,342,0.624,6.1,3464,1248,2190,0.36,6721,0.515,430,0.551,6.5,2014-15,Rebounding
1610612743,DEN,Denver Nuggets,82,30,52,18628.0,1012,609,365,0.602,2678,0.378,77,0.389,7.6,2653,728,1920,0.274,4413,0.601,341,0.652,6.2,3665,1337,2285,0.365,7091,0.517,418,0.549,6.6,2014-15,Rebounding
1610612765,DET,Detroit Pistons,82,32,50,18491.0,1051,647,390,0.616,2561,0.41,68,0.422,7.0,2629,752,1869,0.286,4437,0.593,360,0.645,6.2,3680,1399,2259,0.38,6998,0.526,428,0.56,6.4,2014-15,Rebounding
1610612744,GSW,Golden State Warriors,82,67,15,18865.0,853,518,325,0.607,2255,0.378,64,0.389,7.6,2810,895,1908,0.319,4998,0.562,362,0.606,6.2,3663,1413,2233,0.386,7253,0.505,426,0.537,6.6,2014-15,Rebounding
1610612745,HOU,Houston Rockets,81,55,26,18643.0,944,555,373,0.588,2604,0.363,92,0.376,8.2,2597,758,1832,0.292,4711,0.551,396,0.602,6.3,3541,1313,2205,0.371,7315,0.484,488,0.519,6.8,2014-15,Rebounding
1610612754,IND,Indiana Pacers,82,38,44,18594.0,856,517,315,0.604,2289,0.374,65,0.385,7.3,2822,713,2087,0.253,4682,0.603,378,0.656,6.2,3678,1230,2402,0.334,6971,0.528,443,0.563,6.4,2014-15,Rebounding
1610612746,LAC,Los Angeles Clippers,82,56,26,17963.0,784,464,293,0.592,1989,0.394,63,0.407,7.6,2709,732,1976,0.27,4496,0.603,342,0.652,6.3,3493,1196,2269,0.342,6485,0.539,405,0.575,6.6,2014-15,Rebounding
1610612747,LAL,Los Angeles Lakers,82,21,61,19120.0,951,568,367,0.597,2603,0.365,77,0.376,7.4,2647,684,1948,0.258,4568,0.579,407,0.636,6.3,3598,1252,2315,0.348,7171,0.502,484,0.538,6.6,2014-15,Rebounding
1610612763,MEM,Memphis Grizzlies,82,55,27,18908.0,856,569,271,0.665,2287,0.374,70,0.386,6.5,2633,801,1825,0.304,4446,0.592,340,0.641,6.2,3489,1370,2096,0.393,6733,0.518,410,0.552,6.3,2014-15,Rebounding
1610612748,MIA,Miami Heat,81,36,45,18602.0,733,465,251,0.634,2168,0.338,68,0.349,7.6,2430,725,1702,0.298,4476,0.543,389,0.595,6.5,3163,1190,1953,0.376,6644,0.476,457,0.511,6.7,2014-15,Rebounding
1610612749,MIL,Milwaukee Bucks,81,40,41,18781.0,862,530,310,0.615,2288,0.377,91,0.392,7.3,2544,735,1800,0.289,4541,0.56,387,0.612,6.2,3406,1265,2110,0.371,6829,0.499,478,0.536,6.5,2014-15,Rebounding
1610612750,MIN,Minnesota Timberwolves,81,16,65,18828.0,938,576,348,0.614,2525,0.371,82,0.384,7.4,2374,667,1703,0.281,4103,0.579,323,0.628,6.3,3312,1243,2051,0.375,6628,0.5,405,0.532,6.6,2014-15,Rebounding
1610612740,NOP,New Orleans Pelicans,82,45,37,18488.0,942,607,323,0.644,2489,0.378,87,0.392,7.1,2619,808,1809,0.309,4327,0.605,314,0.653,5.9,3561,1415,2132,0.397,6816,0.522,401,0.555,6.2,2014-15,Rebounding
1610612752,NYK,New York Knicks,81,17,64,18722.0,862,496,349,0.575,2286,0.377,86,0.392,8.4,2412,627,1783,0.26,4259,0.566,346,0.616,6.3,3274,1123,2132,0.343,6545,0.5,432,0.536,6.8,2014-15,Rebounding
1610612760,OKC,Oklahoma City Thunder,82,45,37,18932.0,1052,608,408,0.578,2808,0.375,95,0.388,7.3,2844,781,2051,0.275,4692,0.606,381,0.66,6.3,3896,1389,2459,0.357,7500,0.519,476,0.555,6.6,2014-15,Rebounding
1610612753,ORL,Orlando Magic,82,25,57,18656.0,821,478,316,0.582,2101,0.391,74,0.405,7.0,2607,771,1827,0.296,4247,0.614,344,0.668,6.0,3428,1249,2143,0.364,6348,0.54,418,0.578,6.3,2014-15,Rebounding
1610612755,PHI,Philadelphia 76ers,82,18,64,19043.0,977,565,393,0.578,2650,0.369,99,0.383,7.7,2535,745,1787,0.294,4651,0.545,396,0.596,6.3,3512,1310,2180,0.373,7301,0.481,495,0.516,6.6,2014-15,Rebounding
1610612756,PHX,Phoenix Suns,82,39,43,19044.0,895,533,351,0.596,2355,0.38,85,0.394,7.9,2642,778,1853,0.294,4859,0.544,411,0.594,6.1,3537,1311,2204,0.371,7214,0.49,496,0.526,6.5,2014-15,Rebounding
1610612757,POR,Portland Trail Blazers,82,51,31,18767.0,879,555,303,0.631,2306,0.381,69,0.393,7.5,2880,788,2091,0.274,4982,0.578,429,0.633,5.8,3759,1343,2394,0.357,7288,0.516,498,0.554,6.2,2014-15,Rebounding
1610612758,SAC,Sacramento Kings,82,29,53,18668.0,895,541,316,0.604,2521,0.355,83,0.367,7.3,2727,710,2013,0.26,4542,0.6,335,0.648,6.3,3622,1251,2329,0.345,7063,0.513,418,0.545,6.5,2014-15,Rebounding
1610612759,SAS,San Antonio Spurs,82,55,27,18935.0,805,463,328,0.575,2212,0.364,95,0.38,8.6,2770,853,1910,0.308,4825,0.574,393,0.625,6.0,3575,1316,2238,0.368,7037,0.508,488,0.546,6.6,2014-15,Rebounding
1610612761,TOR,Toronto Raptors,82,49,33,18927.0,881,546,325,0.62,2387,0.369,65,0.379,7.6,2526,731,1788,0.289,4536,0.557,350,0.603,6.0,3407,1277,2113,0.375,6923,0.492,415,0.524,6.4,2014-15,Rebounding
1610612762,UTA,Utah Jazz,82,38,44,18611.0,987,613,356,0.621,2433,0.406,76,0.419,7.3,2617,741,1869,0.283,4478,0.584,337,0.632,6.4,3604,1354,2225,0.376,6911,0.521,413,0.555,6.7,2014-15,Rebounding
1610612764,WAS,Washington Wizards,82,46,36,19321.0,862,482,367,0.559,2367,0.364,96,0.38,8.1,2800,663,2124,0.237,4795,0.584,356,0.631,6.2,3662,1145,2491,0.313,7162,0.511,452,0.546,6.7,2014-15,Rebounding
1610612737,ATL,Atlanta Hawks,82,48,34,18816.0,679,414,261,0.61,1970,0.345,49,0.353,7.8,2770,671,2096,0.242,5106,0.542,428,0.592,6.5,3449,1085,2357,0.315,7076,0.487,477,0.523,6.8,2015-16,Rebounding
1610612738,BOS,Boston Celtics,81,47,34,18821.0,943,545,385,0.578,2575,0.366,82,0.378,7.9,2699,721,1969,0.267,4561,0.592,348,0.641,6.2,3642,1266,2354,0.348,7136,0.51,430,0.543,6.6,2015-16,Rebounding
1610612751,BKN,Brooklyn Nets,82,21,61,18619.0,862,521,322,0.604,2319,0.372,85,0.386,7.6,2613,614,1994,0.235,4279,0.611,342,0.664,6.4,3475,1135,2316,0.327,6598,0.527,427,0.563,6.7,2015-16,Rebounding
1610612766,CHA,Charlotte Hornets,82,48,34,19152.0,733,414,303,0.565,2084,0.352,73,0.364,8.4,2867,652,2213,0.227,4967,0.577,417,0.63,6.1,3600,1066,2516,0.296,7051,0.511,490,0.549,6.6,2015-16,Rebounding
1610612741,CHI,Chicago Bulls,82,42,40,18949.0,906,546,344,0.603,2465,0.368,75,0.379,7.2,2888,755,2132,0.261,5072,0.569,433,0.623,6.3,3794,1301,2476,0.343,7537,0.503,508,0.54,6.5,2015-16,Rebounding
1610612739,CLE,Cleveland Cavaliers,82,57,25,18579.0,872,519,330,0.595,2331,0.374,69,0.385,7.8,2777,675,2086,0.243,4572,0.607,366,0.66,6.1,3649,1194,2416,0.327,6903,0.529,435,0.564,6.5,2015-16,Rebounding
1610612742,DAL,Dallas Mavericks,82,42,40,19014.0,751,445,289,0.593,2047,0.367,78,0.381,8.2,2779,692,2078,0.249,4673,0.595,378,0.647,5.9,3530,1137,2367,0.322,6720,0.525,456,0.564,6.4,2015-16,Rebounding
1610612743,DEN,Denver Nuggets,82,33,49,19032.0,940,557,363,0.593,2583,0.364,55,0.372,7.4,2718,686,2025,0.252,4603,0.59,388,0.645,6.1,3658,1243,2388,0.34,7186,0.509,443,0.542,6.4,2015-16,Rebounding
1610612765,DET,Detroit Pistons,82,44,38,19080.0,1019,621,345,0.609,2454,0.415,51,0.424,7.1,2777,747,2014,0.269,4537,0.612,369,0.666,5.8,3796,1368,2359,0.36,6991,0.543,420,0.578,6.2,2015-16,Rebounding
1610612744,GSW,Golden State Warriors,82,73,9,19087.0,816,483,318,0.592,2146,0.38,55,0.39,8.3,2970,836,2127,0.281,5201,0.571,424,0.622,6.3,3786,1319,2445,0.348,7347,0.515,479,0.551,6.7,2015-16,Rebounding
1610612745,HOU,Houston Rockets,82,41,41,18474.0,930,569,352,0.612,2444,0.381,65,0.391,7.3,2600,712,1881,0.274,4406,0.59,326,0.637,6.4,3530,1281,2233,0.363,6850,0.515,391,0.547,6.7,2015-16,Rebounding
1610612754,IND,Indiana Pacers,82,45,37,19076.0,847,490,347,0.579,2237,0.379,59,0.389,8.2,2779,710,2063,0.255,4831,0.575,391,0.626,6.2,3626,1200,2410,0.331,7068,0.513,450,0.548,6.7,2015-16,Rebounding
1610612746,LAC,LA Clippers,82,53,29,18241.0,720,402,305,0.558,1815,0.397,76,0.414,8.1,2722,683,2026,0.251,4806,0.566,345,0.61,6.4,3442,1085,2331,0.315,6621,0.52,421,0.555,6.7,2015-16,Rebounding
1610612747,LAL,Los Angeles Lakers,82,17,65,18842.0,877,499,368,0.569,2586,0.339,86,0.351,8.4,2645,581,2061,0.22,4586,0.577,355,0.625,6.3,3522,1080,2429,0.307,7172,0.491,441,0.523,6.8,2015-16,Rebounding
1610612763,MEM,Memphis Grizzlies,82,42,40,18899.0,915,568,319,0.621,2450,0.373,79,0.386,7.1,2495,639,1850,0.256,4155,0.6,335,0.653,6.4,3410,1207,2169,0.354,6605,0.516,414,0.551,6.6,2015-16,Rebounding
1610612748,MIA,Miami Heat,82,48,34,19221.0,807,502,292,0.622,2164,0.373,58,0.383,6.9,2810,725,2080,0.258,4919,0.571,395,0.621,6.4,3617,1227,2372,0.339,7083,0.511,453,0.546,6.5,2015-16,Rebounding
1610612749,MIL,Milwaukee Bucks,82,33,49,18886.0,858,519,325,0.605,2296,0.374,78,0.387,7.0,2559,697,1850,0.272,4471,0.572,319,0.616,6.4,3417,1216,2175,0.356,6767,0.505,397,0.536,6.6,2015-16,Rebounding
1610612750,MIN,Minnesota Timberwolves,82,29,53,18382.0,821,487,326,0.593,2180,0.377,64,0.388,7.7,2586,729,1854,0.282,4286,0.603,305,0.65,6.2,3407,1216,2180,0.357,6466,0.527,369,0.559,6.6,2015-16,Rebounding
1610612740,NOP,New Orleans Pelicans,82,30,52,18915.0,780,463,289,0.594,2059,0.379,44,0.387,7.3,2712,659,2046,0.243,4411,0.615,350,0.668,6.1,3492,1122,2335,0.321,6470,0.54,394,0.575,6.4,2015-16,Rebounding
1610612752,NYK,New York Knicks,82,32,50,18956.0,849,521,314,0.614,2179,0.39,60,0.401,8.0,2787,666,2114,0.239,4718,0.591,396,0.645,6.4,3636,1187,2428,0.326,6897,0.527,456,0.565,6.8,2015-16,Rebounding
1610612760,OKC,Oklahoma City Thunder,82,55,27,18597.0,1071,663,365,0.619,2693,0.398,87,0.411,7.0,2916,703,2207,0.241,4959,0.588,392,0.638,6.0,3987,1366,2572,0.343,7652,0.521,479,0.556,6.2,2015-16,Rebounding
1610612753,ORL,Orlando Magic,81,35,46,18641.0,835,476,335,0.57,2205,0.379,62,0.39,7.7,2669,718,1950,0.269,4394,0.607,364,0.662,5.9,3504,1194,2285,0.341,6599,0.531,426,0.568,6.3,2015-16,Rebounding
1610612755,PHI,Philadelphia 76ers,82,10,72,18835.0,777,437,327,0.562,2176,0.357,65,0.368,7.8,2603,625,1970,0.24,4664,0.558,392,0.609,6.1,3380,1062,2297,0.314,6840,0.494,457,0.53,6.5,2015-16,Rebounding
1610612756,PHX,Phoenix Suns,82,23,59,18502.0,943,537,374,0.569,2583,0.365,95,0.379,7.9,2732,715,2009,0.262,4488,0.609,361,0.662,5.9,3675,1252,2383,0.341,7071,0.52,456,0.556,6.4,2015-16,Rebounding
1610612757,POR,Portland Trail Blazers,82,44,38,19012.0,948,537,394,0.566,2574,0.368,83,0.381,8.0,2782,723,2055,0.26,4735,0.588,408,0.643,6.0,3730,1260,2449,0.338,7309,0.51,491,0.547,6.5,2015-16,Rebounding
1610612758,SAC,Sacramento Kings,81,33,48,18485.0,859,485,342,0.565,2379,0.361,79,0.373,7.3,2723,644,2079,0.237,4590,0.593,376,0.646,6.3,3582,1129,2421,0.315,6969,0.514,455,0.55,6.5,2015-16,Rebounding
1610612759,SAS,San Antonio Spurs,82,67,15,18351.0,768,443,311,0.577,1905,0.403,59,0.416,8.1,2827,741,2070,0.262,4583,0.617,351,0.668,6.3,3595,1184,2381,0.329,6488,0.554,410,0.591,6.7,2015-16,Rebounding
1610612761,TOR,Toronto Raptors,81,55,26,18800.0,825,516,302,0.625,2372,0.348,57,0.356,7.2,2687,715,1967,0.266,4711,0.57,359,0.617,5.9,3512,1231,2269,0.351,7083,0.496,416,0.527,6.2,2015-16,Rebounding
1610612762,UTA,Utah Jazz,82,40,42,18869.0,879,521,355,0.593,2394,0.367,75,0.379,8.1,2665,635,2018,0.238,4573,0.583,376,0.635,6.3,3544,1156,2373,0.326,6967,0.509,451,0.544,6.7,2015-16,Rebounding
1610612764,WAS,Washington Wizards,82,41,41,18987.0,742,412,319,0.555,2152,0.345,76,0.357,9.0,2688,608,2073,0.226,4653,0.578,397,0.632,6.3,3430,1020,2392,0.297,6805,0.504,473,0.542,6.9,2015-16,Rebounding
1610612737,ATL,Atlanta Hawks,82,43,39,18932.0,841,485,330,0.577,2443,0.344,50,0.351,7.4,2791,718,2058,0.257,5184,0.538,430,0.587,6.0,3632,1203,2388,0.331,7620,0.477,480,0.509,6.3,2016-17,Rebounding
1610612738,BOS,Boston Celtics,82,53,29,19147.0,742,415,317,0.559,2382,0.312,62,0.32,8.4,2698,666,2022,0.247,4768,0.566,363,0.612,6.4,3440,1081,2339,0.314,7142,0.482,425,0.512,6.8,2016-17,Rebounding
1610612751,BKN,Brooklyn Nets,81,20,61,18768.0,707,439,253,0.621,2205,0.321,58,0.329,7.7,2841,624,2212,0.22,5042,0.563,416,0.614,6.4,3548,1063,2465,0.3,7239,0.49,474,0.524,6.6,2016-17,Rebounding
1610612766,CHA,Charlotte Hornets,82,36,46,19086.0,721,419,291,0.581,2167,0.333,73,0.344,7.6,2852,661,2183,0.232,4948,0.576,430,0.631,6.2,3573,1080,2474,0.302,7108,0.503,503,0.541,6.5,2016-17,Rebounding
1610612741,CHI,Chicago Bulls,82,41,41,19055.0,999,601,379,0.602,2750,0.363,72,0.373,7.2,2796,686,2106,0.245,4977,0.562,404,0.611,6.2,3795,1287,2485,0.339,7719,0.492,476,0.524,6.4,2016-17,Rebounding
1610612739,CLE,Cleveland Cavaliers,82,51,31,18657.0,766,450,300,0.587,2157,0.355,70,0.367,8.0,2821,684,2131,0.242,4783,0.59,354,0.637,6.3,3587,1134,2431,0.316,6928,0.518,424,0.552,6.7,2016-17,Rebounding
1610612742,DAL,Dallas Mavericks,81,32,49,18487.0,637,318,310,0.499,1785,0.357,68,0.371,9.5,2491,605,1881,0.243,4313,0.578,350,0.629,6.3,3128,923,2191,0.295,6088,0.514,418,0.552,7.0,2016-17,Rebounding
1610612743,DEN,Denver Nuggets,81,39,42,18896.0,953,609,320,0.639,2493,0.382,78,0.395,7.2,2801,695,2090,0.248,4707,0.595,415,0.653,6.2,3754,1304,2410,0.347,7190,0.522,493,0.561,6.5,2016-17,Rebounding
1610612765,DET,Detroit Pistons,82,37,45,18925.0,907,580,304,0.639,2321,0.391,60,0.401,6.9,2837,724,2107,0.255,4703,0.603,435,0.665,5.6,3744,1304,2411,0.348,7010,0.534,495,0.575,5.9,2016-17,Rebounding
1610612744,GSW,Golden State Warriors,82,67,15,18790.0,769,417,341,0.542,2087,0.368,78,0.383,7.9,2872,771,2089,0.268,5029,0.571,396,0.62,6.7,3641,1188,2430,0.326,7107,0.512,474,0.549,7.0,2016-17,Rebounding
1610612745,HOU,Houston Rockets,82,55,27,19193.0,892,505,376,0.566,2430,0.367,65,0.377,8.5,2746,699,2029,0.255,4885,0.562,382,0.61,6.5,3638,1204,2405,0.331,7309,0.498,447,0.53,7.0,2016-17,Rebounding
1610612754,IND,Indiana Pacers,81,42,39,18855.0,730,416,304,0.57,2068,0.353,66,0.365,8.0,2680,651,2023,0.243,4646,0.577,369,0.627,6.5,3410,1067,2327,0.313,6707,0.508,435,0.544,6.8,2016-17,Rebounding
1610612746,LAC,LA Clippers,82,51,31,18330.0,738,446,276,0.604,1886,0.391,53,0.403,7.3,2789,687,2099,0.246,4625,0.603,317,0.647,6.3,3527,1133,2375,0.321,6499,0.543,370,0.575,6.5,2016-17,Rebounding
1610612747,LAL,Los Angeles Lakers,82,26,56,18717.0,932,534,382,0.573,2631,0.354,91,0.367,7.2,2635,619,2013,0.235,4531,0.582,368,0.633,6.5,3567,1153,2395,0.323,7150,0.499,459,0.533,6.7,2016-17,Rebounding
1610612763,MEM,Memphis Grizzlies,82,43,39,18925.0,886,543,329,0.613,2409,0.368,70,0.379,7.3,2620,663,1947,0.253,4381,0.598,365,0.652,6.2,3506,1206,2276,0.344,6777,0.517,435,0.553,6.5,2016-17,Rebounding
1610612748,MIA,Miami Heat,82,41,41,19145.0,872,519,344,0.595,2503,0.348,84,0.36,7.4,2704,687,2007,0.254,4982,0.543,424,0.593,6.1,3576,1206,2351,0.337,7477,0.478,508,0.513,6.4,2016-17,Rebounding
1610612749,MIL,Milwaukee Bucks,82,42,40,18415.0,723,446,262,0.617,1983,0.365,55,0.375,7.5,2586,662,1916,0.256,4505,0.574,342,0.621,6.6,3309,1108,2178,0.335,6478,0.511,397,0.544,6.8,2016-17,Rebounding
1610612750,MIN,Minnesota Timberwolves,82,31,51,18846.0,936,562,356,0.6,2505,0.374,83,0.386,7.9,2539,683,1846,0.269,4271,0.594,318,0.642,6.1,3475,1245,2202,0.358,6770,0.513,401,0.546,6.6,2016-17,Rebounding
1610612740,NOP,New Orleans Pelicans,82,34,48,18859.0,703,410,277,0.583,1878,0.374,57,0.386,7.1,2877,746,2123,0.259,4968,0.579,366,0.625,6.2,3580,1156,2400,0.323,6836,0.524,423,0.558,6.4,2016-17,Rebounding
1610612752,NYK,New York Knicks,82,31,51,18974.0,983,575,384,0.585,2542,0.387,76,0.399,7.5,2721,642,2071,0.236,4742,0.574,371,0.623,6.6,3704,1217,2455,0.329,7280,0.509,447,0.542,6.8,2016-17,Rebounding
1610612760,OKC,Oklahoma City Thunder,82,47,35,18548.0,1002,606,368,0.605,2845,0.352,74,0.362,7.1,2819,669,2147,0.237,4733,0.596,350,0.643,6.0,3821,1275,2515,0.334,7560,0.505,424,0.535,6.3,2016-17,Rebounding
1610612753,ORL,Orlando Magic,82,29,53,18526.0,806,463,318,0.574,2140,0.377,61,0.388,8.0,2734,703,2025,0.257,4551,0.601,357,0.652,6.2,3540,1166,2343,0.329,6679,0.53,418,0.565,6.6,2016-17,Rebounding
1610612755,PHI,Philadelphia 76ers,82,28,54,18855.0,806,456,338,0.566,2421,0.333,77,0.344,8.4,2705,687,2014,0.254,4731,0.572,384,0.622,6.1,3511,1143,2352,0.326,7143,0.492,461,0.525,6.6,2016-17,Rebounding
1610612756,PHX,Phoenix Suns,80,23,57,18282.0,946,551,369,0.582,2617,0.361,87,0.374,7.9,2644,638,1997,0.241,4597,0.575,374,0.626,6.3,3590,1189,2366,0.331,7199,0.499,461,0.533,6.7,2016-17,Rebounding
1610612757,POR,Portland Trail Blazers,82,41,41,19273.0,830,492,320,0.593,2440,0.34,76,0.351,7.4,2748,715,2017,0.26,5079,0.541,435,0.592,6.2,3578,1207,2337,0.337,7508,0.477,511,0.511,6.4,2016-17,Rebounding
1610612758,SAC,Sacramento Kings,82,32,50,18713.0,715,386,308,0.54,2129,0.336,59,0.345,7.9,2651,612,2029,0.231,4395,0.603,320,0.651,6.3,3366,998,2337,0.296,6502,0.518,379,0.55,6.6,2016-17,Rebounding
1610612759,SAS,San Antonio Spurs,81,61,20,18139.0,815,503,303,0.617,2173,0.375,68,0.387,7.6,2748,706,2035,0.257,4617,0.595,315,0.639,6.3,3563,1209,2338,0.339,6775,0.526,383,0.557,6.6,2016-17,Rebounding
1610612761,TOR,Toronto Raptors,81,50,31,18824.0,858,530,304,0.618,2411,0.356,82,0.368,7.5,2640,703,1935,0.266,4786,0.552,402,0.602,6.1,3498,1233,2239,0.352,7185,0.487,484,0.522,6.4,2016-17,Rebounding
1610612762,UTA,Utah Jazz,82,51,31,18930.0,771,469,295,0.608,2014,0.383,46,0.392,7.7,2774,646,2125,0.233,4855,0.571,403,0.623,6.2,3545,1115,2420,0.315,6858,0.517,449,0.553,6.5,2016-17,Rebounding
1610612764,WAS,Washington Wizards,82,49,33,18724.0,842,453,376,0.538,2446,0.344,104,0.36,8.1,2669,621,2034,0.233,4546,0.587,350,0.636,6.4,3511,1074,2410,0.306,6982,0.503,454,0.538,6.8,2016-17,Rebounding
1610612737,ATL,Atlanta Hawks,81,24,57,18488.0,737,380,352,0.516,2449,0.301,65,0.309,8.4,2662,605,2046,0.227,4746,0.561,368,0.608,6.0,3399,985,2398,0.29,7004,0.485,433,0.517,6.5,2017-18,Rebounding
1610612738,BOS,Boston Celtics,79,52,27,18463.0,741,420,323,0.567,2255,0.329,60,0.338,8.0,2772,665,2093,0.24,4780,0.58,353,0.626,6.3,3513,1085,2416,0.309,6830,0.514,413,0.547,6.6,2017-18,Rebounding
1610612751,BKN,Brooklyn Nets,80,27,53,18544.0,777,414,365,0.533,2436,0.319,77,0.329,8.2,2775,567,2199,0.204,4832,0.574,344,0.618,6.0,3552,981,2564,0.276,7035,0.505,421,0.537,6.5,2017-18,Rebounding
1610612766,CHA,Charlotte Hornets,82,36,46,18821.0,826,499,320,0.604,2407,0.343,69,0.353,7.0,2901,613,2278,0.211,4851,0.598,364,0.647,6.2,3727,1112,2598,0.298,7095,0.525,433,0.559,6.4,2017-18,Rebounding
1610612741,CHI,Chicago Bulls,81,27,54,18895.0,778,442,321,0.568,2397,0.325,52,0.332,7.6,2837,549,2287,0.194,4835,0.587,398,0.639,6.0,3615,991,2608,0.274,7035,0.514,450,0.549,6.4,2017-18,Rebounding
1610612739,CLE,Cleveland Cavaliers,82,50,32,18431.0,694,405,284,0.584,2027,0.342,63,0.353,8.1,2759,591,2153,0.214,4570,0.604,296,0.646,6.2,3453,996,2437,0.288,6388,0.541,359,0.573,6.6,2017-18,Rebounding
1610612742,DAL,Dallas Mavericks,82,24,58,19187.0,665,370,292,0.556,2185,0.304,62,0.313,8.3,2717,610,2101,0.225,4734,0.574,387,0.625,6.1,3382,980,2393,0.29,6696,0.505,449,0.541,6.6,2017-18,Rebounding
1610612743,DEN,Denver Nuggets,81,45,36,18769.0,894,547,334,0.612,2553,0.35,51,0.357,7.3,2719,661,2057,0.243,4588,0.593,299,0.634,5.8,3613,1208,2391,0.334,6907,0.523,350,0.551,6.2,2017-18,Rebounding
1610612765,DET,Detroit Pistons,82,39,43,18492.0,830,483,340,0.582,2368,0.351,59,0.359,7.0,2756,654,2089,0.237,4846,0.569,353,0.613,5.9,3586,1137,2429,0.317,7041,0.509,412,0.541,6.2,2017-18,Rebounding
1610612744,GSW,Golden State Warriors,82,58,24,18642.0,690,384,303,0.557,1982,0.348,58,0.359,8.4,2877,713,2148,0.248,5107,0.563,357,0.606,6.3,3567,1097,2451,0.308,6884,0.518,415,0.551,6.7,2017-18,Rebounding
1610612745,HOU,Houston Rockets,82,65,17,19245.0,738,420,314,0.569,2250,0.328,58,0.337,8.1,2825,625,2189,0.221,4764,0.593,351,0.64,6.3,3563,1045,2503,0.293,6806,0.524,409,0.557,6.6,2017-18,Rebounding
1610612754,IND,Indiana Pacers,82,48,34,18940.0,788,455,332,0.577,2368,0.333,64,0.342,7.7,2681,600,2070,0.224,4697,0.571,320,0.613,6.2,3469,1055,2402,0.304,6860,0.506,384,0.536,6.6,2017-18,Rebounding
1610612746,LAC,LA Clippers,81,41,40,18451.0,825,485,340,0.588,2416,0.341,70,0.352,7.4,2728,611,2108,0.224,4668,0.584,338,0.63,6.2,3553,1096,2448,0.308,6876,0.517,408,0.549,6.5,2017-18,Rebounding
1610612747,LAL,Los Angeles Lakers,81,35,46,18994.0,864,511,354,0.591,2498,0.346,78,0.357,7.4,2894,660,2227,0.228,4954,0.584,350,0.629,6.2,3758,1171,2581,0.312,7235,0.519,428,0.552,6.5,2017-18,Rebounding
1610612763,MEM,Memphis Grizzlies,82,22,60,18732.0,778,433,338,0.557,2494,0.312,59,0.32,8.3,2544,575,1961,0.226,4436,0.573,305,0.616,6.2,3322,1008,2299,0.303,6672,0.498,364,0.527,6.7,2017-18,Rebounding
1610612748,MIA,Miami Heat,81,43,38,19163.0,755,420,327,0.556,2309,0.327,63,0.336,8.2,2765,647,2112,0.234,4891,0.565,361,0.61,6.1,3520,1067,2439,0.303,6985,0.504,424,0.537,6.6,2017-18,Rebounding
1610612749,MIL,Milwaukee Bucks,81,44,37,18503.0,686,369,314,0.538,2009,0.341,45,0.349,8.0,2544,579,1943,0.228,4464,0.57,307,0.612,6.4,3230,948,2257,0.293,6231,0.518,352,0.549,6.8,2017-18,Rebounding
1610612750,MIN,Minnesota Timberwolves,82,47,35,18638.0,846,482,361,0.57,2345,0.361,62,0.371,8.0,2593,659,1926,0.254,4449,0.583,304,0.626,6.2,3439,1141,2287,0.332,6610,0.52,366,0.551,6.6,2017-18,Rebounding
1610612740,NOP,New Orleans Pelicans,82,48,34,18682.0,711,383,308,0.539,2032,0.35,51,0.359,7.8,2918,702,2202,0.241,4943,0.59,320,0.631,6.3,3629,1085,2510,0.299,6781,0.535,371,0.566,6.6,2017-18,Rebounding
1610612752,NYK,New York Knicks,81,28,53,18346.0,853,510,328,0.598,2389,0.357,53,0.365,7.3,2722,621,2088,0.228,4667,0.583,311,0.625,6.2,3575,1131,2416,0.316,6859,0.521,364,0.55,6.5,2017-18,Rebounding
1610612760,OKC,Oklahoma City Thunder,80,48,32,18407.0,989,539,438,0.545,2739,0.361,94,0.374,8.3,2606,578,2026,0.222,4567,0.571,301,0.611,6.4,3595,1117,2464,0.311,7090,0.507,395,0.537,6.9,2017-18,Rebounding
1610612753,ORL,Orlando Magic,82,25,57,18434.0,720,400,317,0.556,2218,0.325,52,0.332,8.6,2681,629,2029,0.235,4584,0.585,310,0.627,6.1,3401,1029,2346,0.303,6590,0.516,362,0.546,6.6,2017-18,Rebounding
1610612755,PHI,Philadelphia 76ers,81,52,29,18634.0,890,498,385,0.56,2570,0.346,80,0.357,8.5,2962,695,2259,0.235,5205,0.569,377,0.614,6.2,3852,1193,2644,0.31,7488,0.514,457,0.548,6.7,2017-18,Rebounding
1610612756,PHX,Phoenix Suns,82,21,61,18470.0,842,494,342,0.587,2556,0.329,65,0.338,7.1,2776,606,2163,0.218,4814,0.577,334,0.62,6.1,3618,1100,2505,0.304,7130,0.507,399,0.538,6.3,2017-18,Rebounding
1610612757,POR,Portland Trail Blazers,82,49,33,18853.0,835,485,334,0.581,2601,0.321,69,0.33,7.7,2893,695,2178,0.24,4969,0.582,384,0.631,5.9,3728,1180,2512,0.317,7372,0.506,453,0.539,6.3,2017-18,Rebounding
1610612758,SAC,Sacramento Kings,82,27,55,18823.0,776,449,315,0.579,2244,0.346,50,0.354,7.5,2577,521,2037,0.202,4419,0.583,302,0.626,6.0,3353,970,2352,0.289,6464,0.519,352,0.549,6.4,2017-18,Rebounding
1610612759,SAS,San Antonio Spurs,82,47,35,18424.0,848,499,338,0.588,2319,0.366,62,0.376,7.1,2776,620,2154,0.223,4721,0.588,331,0.632,6.2,3624,1119,2492,0.309,6842,0.53,393,0.562,6.4,2017-18,Rebounding
1610612761,TOR,Toronto Raptors,82,59,23,18959.0,799,468,331,0.586,2483,0.322,82,0.333,7.9,2806,663,2128,0.236,4969,0.565,352,0.608,6.1,3605,1131,2459,0.314,7239,0.498,434,0.53,6.5,2017-18,Rebounding
1610612762,UTA,Utah Jazz,82,48,34,18988.0,740,407,328,0.55,2254,0.328,54,0.336,7.8,2805,591,2197,0.211,4879,0.575,339,0.618,6.2,3545,998,2525,0.282,6926,0.512,393,0.543,6.6,2017-18,Rebounding
1610612764,WAS,Washington Wizards,82,43,39,19113.0,822,438,380,0.533,2560,0.321,97,0.334,8.3,2711,550,2134,0.203,4673,0.58,329,0.624,6.4,3533,988,2514,0.28,7005,0.504,426,0.537,6.9,2017-18,Rebounding
1610612737,ATL,Atlanta Hawks,82,29,53,19015.0,955,576,375,0.603,2437,0.392,82,0.406,7.5,2823,624,2200,0.221,4816,0.586,385,0.637,6.3,3778,1200,2575,0.318,6996,0.54,467,0.579,6.6,2018-19,Rebounding
1610612738,BOS,Boston Celtics,82,49,33,19408.0,804,436,365,0.542,2063,0.39,64,0.402,8.2,2849,610,2237,0.214,4802,0.593,401,0.647,6.6,3653,1046,2602,0.286,6670,0.548,465,0.589,7.0,2018-19,Rebounding
1610612751,BKN,Brooklyn Nets,82,42,40,19166.0,900,504,390,0.56,2357,0.382,74,0.394,7.8,2919,638,2277,0.219,5122,0.57,465,0.627,6.0,3819,1142,2667,0.299,7288,0.524,539,0.566,6.4,2018-19,Rebounding
1610612766,CHA,Charlotte Hornets,82,39,43,19063.0,814,499,314,0.613,2219,0.367,76,0.38,7.5,2777,673,2102,0.242,4712,0.589,437,0.65,6.3,3591,1172,2416,0.326,6768,0.531,513,0.574,6.6,2018-19,Rebounding
1610612741,CHI,Chicago Bulls,81,22,59,18830.0,717,443,270,0.618,1897,0.378,52,0.389,7.3,2767,578,2182,0.209,4572,0.605,384,0.661,6.2,3484,1021,2452,0.293,6283,0.555,436,0.596,6.4,2018-19,Rebounding
1610612739,CLE,Cleveland Cavaliers,82,19,63,18612.0,878,515,351,0.587,2225,0.395,84,0.41,7.1,2612,555,2029,0.212,4336,0.602,379,0.66,6.2,3490,1070,2380,0.307,6390,0.546,463,0.589,6.5,2018-19,Rebounding
1610612742,DAL,Dallas Mavericks,82,33,49,18446.0,832,462,368,0.555,2100,0.396,73,0.41,8.1,2884,638,2244,0.221,4692,0.615,389,0.67,6.3,3716,1100,2612,0.296,6606,0.563,462,0.605,6.7,2018-19,Rebounding
1610612743,DEN,Denver Nuggets,82,54,28,18706.0,971,607,363,0.625,2475,0.392,84,0.406,7.4,2831,634,2189,0.224,4645,0.609,366,0.662,6.3,3802,1241,2552,0.326,6905,0.551,450,0.589,6.5,2018-19,Rebounding
1610612765,DET,Detroit Pistons,82,41,41,18452.0,935,569,358,0.609,2254,0.415,68,0.428,7.2,2752,641,2109,0.233,4444,0.619,342,0.671,6.0,3687,1210,2467,0.328,6467,0.57,410,0.609,6.3,2018-19,Rebounding
1610612744,GSW,Golden State Warriors,82,57,25,19157.0,794,432,356,0.544,1872,0.424,73,0.441,7.7,2982,714,2251,0.239,4949,0.603,417,0.658,6.3,3776,1146,2607,0.303,6617,0.571,490,0.616,6.6,2018-19,Rebounding
1610612745,HOU,Houston Rockets,82,53,29,18939.0,836,485,346,0.58,2095,0.399,61,0.411,8.1,2610,600,1995,0.23,4520,0.577,388,0.632,6.3,3446,1085,2341,0.315,6424,0.536,449,0.577,6.8,2018-19,Rebounding
1610612754,IND,Indiana Pacers,82,48,34,18619.0,762,458,302,0.601,2048,0.372,82,0.388,7.0,2766,606,2151,0.219,4685,0.59,399,0.645,6.4,3528,1064,2453,0.302,6541,0.539,481,0.582,6.5,2018-19,Rebounding
1610612746,LAC,LA Clippers,82,48,34,18993.0,795,429,360,0.54,2059,0.386,73,0.4,7.5,2935,658,2274,0.224,4895,0.6,455,0.661,6.1,3730,1087,2634,0.291,6729,0.554,528,0.602,6.4,2018-19,Rebounding
1610612747,LAL,Los Angeles Lakers,82,37,45,19012.0,835,487,346,0.583,2083,0.401,77,0.416,7.7,2984,679,2296,0.228,4914,0.607,429,0.665,6.3,3819,1166,2642,0.305,6827,0.559,506,0.604,6.6,2018-19,Rebounding
1610612763,MEM,Memphis Grizzlies,82,33,49,19109.0,723,430,287,0.595,1963,0.368,54,0.379,7.9,2703,664,2031,0.246,4464,0.606,373,0.661,6.3,3426,1094,2318,0.319,6225,0.55,427,0.591,6.7,2018-19,Rebounding
1610612748,MIA,Miami Heat,82,39,43,19097.0,921,554,362,0.602,2244,0.41,90,0.428,7.2,2878,634,2241,0.22,4912,0.586,471,0.648,6.6,3799,1188,2603,0.313,6960,0.546,561,0.594,6.7,2018-19,Rebounding
1610612749,MIL,Milwaukee Bucks,82,60,22,19298.0,762,462,293,0.606,1949,0.391,51,0.401,7.7,3315,695,2615,0.21,5287,0.627,442,0.684,6.4,4077,1157,2908,0.284,7026,0.58,493,0.624,6.6,2018-19,Rebounding
1610612750,MIN,Minnesota Timberwolves,82,36,46,19058.0,922,552,366,0.599,2346,0.393,87,0.408,8.2,2749,640,2106,0.233,4637,0.593,400,0.649,6.3,3671,1192,2472,0.325,6784,0.541,487,0.583,6.7,2018-19,Rebounding
1610612740,NOP,New Orleans Pelicans,82,33,49,18735.0,908,531,366,0.585,2234,0.406,80,0.422,7.3,2969,735,2231,0.248,4727,0.628,401,0.686,6.2,3877,1266,2597,0.327,6759,0.574,481,0.618,6.5,2018-19,Rebounding
1610612752,NYK,New York Knicks,81,17,64,18746.0,851,535,309,0.629,2218,0.384,66,0.395,7.4,2775,574,2199,0.207,4591,0.604,393,0.661,6.5,3626,1109,2508,0.306,6595,0.55,459,0.591,6.7,2018-19,Rebounding
1610612760,OKC,Oklahoma City Thunder,81,48,33,18767.0,1020,530,476,0.52,2514,0.406,98,0.422,7.9,2877,582,2289,0.202,4759,0.605,367,0.655,6.8,3897,1112,2765,0.285,7037,0.554,465,0.593,7.1,2018-19,Rebounding
1610612753,ORL,Orlando Magic,80,40,40,18342.0,809,502,302,0.621,1852,0.437,71,0.454,7.4,2823,679,2130,0.241,4495,0.628,341,0.68,6.0,3632,1181,2432,0.325,6199,0.586,412,0.628,6.3,2018-19,Rebounding
1610612755,PHI,Philadelphia 76ers,81,51,30,18605.0,880,529,349,0.601,2178,0.404,79,0.419,7.6,2990,674,2312,0.225,4877,0.613,403,0.668,6.3,3870,1203,2661,0.311,6839,0.566,482,0.609,6.6,2018-19,Rebounding
1610612756,PHX,Phoenix Suns,82,19,63,18793.0,748,440,306,0.588,1929,0.388,52,0.399,7.9,2562,577,1983,0.225,4419,0.58,374,0.633,6.4,3310,1017,2289,0.307,6121,0.541,426,0.581,6.8,2018-19,Rebounding
1610612757,POR,Portland Trail Blazers,82,53,29,19026.0,966,582,372,0.602,2371,0.407,97,0.425,7.4,2968,665,2286,0.224,4846,0.612,404,0.668,5.9,3934,1247,2658,0.317,7016,0.561,501,0.604,6.3,2018-19,Rebounding
1610612758,SAC,Sacramento Kings,82,39,43,18819.0,906,524,376,0.578,2169,0.418,94,0.437,7.2,2819,650,2162,0.231,4687,0.601,386,0.655,6.4,3725,1174,2538,0.315,6656,0.56,480,0.603,6.6,2018-19,Rebounding
1610612759,SAS,San Antonio Spurs,82,48,34,18997.0,757,459,291,0.606,1827,0.414,44,0.425,7.5,2910,607,2301,0.209,4727,0.616,384,0.67,6.3,3667,1066,2592,0.291,6366,0.576,428,0.618,6.5,2018-19,Rebounding
1610612761,TOR,Toronto Raptors,82,58,24,19157.0,785,471,310,0.6,1960,0.401,59,0.413,7.7,2919,729,2183,0.25,4821,0.605,360,0.654,6.0,3704,1200,2493,0.324,6597,0.561,419,0.6,6.4,2018-19,Rebounding
1610612762,UTA,Utah Jazz,81,50,31,18398.0,807,466,333,0.577,1931,0.418,54,0.43,7.5,2941,605,2320,0.206,4791,0.614,425,0.674,6.3,3748,1071,2653,0.286,6522,0.575,479,0.62,6.6,2018-19,Rebounding
1610612764,WAS,Washington Wizards,81,31,50,18873.0,776,428,335,0.552,1941,0.4,59,0.412,7.9,2639,611,2002,0.232,4504,0.586,348,0.635,6.5,3415,1039,2337,0.304,6249,0.546,407,0.585,6.8,2018-19,Rebounding
1610612737,ATL,Atlanta Hawks,67,20,47,15730.0,661,392,269,0.593,1790,0.369,46,0.379,7.6,2237,485,1745,0.217,3714,0.602,319,0.659,6.3,2898,877,2014,0.303,5308,0.546,365,0.586,6.6,2019-20,Rebounding
1610612738,BOS,Boston Celtics,72,48,24,16758.0,767,488,274,0.636,1904,0.403,49,0.413,7.0,2549,554,1991,0.217,4123,0.618,387,0.682,6.5,3316,1042,2265,0.314,5829,0.569,436,0.615,6.6,2019-20,Rebounding
1610612751,BKN,Brooklyn Nets,72,35,37,16912.0,766,445,316,0.581,1870,0.41,69,0.425,7.8,2683,571,2104,0.213,4303,0.624,374,0.683,6.2,3449,1016,2420,0.295,5987,0.576,443,0.622,6.6,2019-20,Rebounding
1610612766,CHA,Charlotte Hornets,64,23,41,14954.0,707,422,284,0.597,1664,0.425,47,0.437,7.6,2034,475,1558,0.234,3321,0.612,297,0.673,6.2,2741,897,1842,0.327,4844,0.566,344,0.609,6.6,2019-20,Rebounding
1610612741,CHI,Chicago Bulls,65,22,43,15077.0,680,389,287,0.572,1671,0.407,45,0.418,7.8,2041,430,1610,0.211,3303,0.618,288,0.677,6.3,2721,819,1897,0.301,4791,0.568,333,0.61,6.7,2019-20,Rebounding
1610612739,CLE,Cleveland Cavaliers,65,19,46,14769.0,704,437,263,0.621,1706,0.413,60,0.428,7.3,2172,510,1662,0.235,3351,0.648,271,0.705,6.0,2876,947,1925,0.329,4922,0.584,331,0.626,6.3,2019-20,Rebounding
1610612742,DAL,Dallas Mavericks,73,41,32,16977.0,774,439,329,0.567,1747,0.443,51,0.456,8.2,2645,585,2056,0.221,4128,0.641,387,0.707,6.2,3419,1024,2385,0.3,5703,0.6,438,0.649,6.6,2019-20,Rebounding
1610612743,DEN,Denver Nuggets,73,46,27,16867.0,786,513,268,0.653,1818,0.432,65,0.448,6.9,2436,569,1867,0.234,3867,0.63,323,0.687,6.0,3222,1082,2135,0.336,5504,0.585,388,0.63,6.2,2019-20,Rebounding
1610612765,DET,Detroit Pistons,65,20,45,14734.0,638,383,252,0.6,1471,0.434,46,0.448,6.9,2080,471,1606,0.226,3407,0.611,317,0.673,6.3,2718,854,1858,0.314,4739,0.574,363,0.621,6.4,2019-20,Rebounding
1610612744,GSW,Golden State Warriors,65,15,50,15178.0,647,373,272,0.577,1522,0.425,58,0.442,8.1,2138,521,1610,0.244,3557,0.601,343,0.665,6.4,2785,894,1882,0.321,4922,0.566,401,0.616,6.8,2019-20,Rebounding
1610612745,HOU,Houston Rockets,72,44,28,16623.0,703,371,328,0.528,1786,0.394,53,0.406,9.0,2483,583,1895,0.235,4045,0.614,329,0.668,6.6,3186,954,2223,0.299,5647,0.564,382,0.605,7.1,2019-20,Rebounding
1610612754,IND,Indiana Pacers,73,45,28,16874.0,636,386,249,0.607,1486,0.428,36,0.439,7.3,2488,564,1924,0.227,4173,0.596,372,0.655,6.2,3124,950,2173,0.304,5518,0.566,408,0.611,6.4,2019-20,Rebounding
1610612746,LAC,LA Clippers,72,49,23,16671.0,767,476,286,0.621,1774,0.432,50,0.445,6.7,2663,571,2084,0.214,4206,0.633,334,0.688,6.4,3430,1047,2370,0.305,5790,0.592,384,0.634,6.4,2019-20,Rebounding
1610612747,LAL,Los Angeles Lakers,71,52,19,15947.0,757,446,303,0.589,1685,0.449,48,0.462,6.8,2488,544,1944,0.219,3942,0.631,313,0.686,6.2,3245,990,2247,0.305,5438,0.597,361,0.639,6.4,2019-20,Rebounding
1610612763,MEM,Memphis Grizzlies,73,34,39,16713.0,754,461,287,0.611,1837,0.41,61,0.425,7.5,2643,607,2033,0.23,4226,0.625,365,0.685,6.3,3397,1068,2320,0.314,5884,0.577,426,0.622,6.5,2019-20,Rebounding
1610612748,MIA,Miami Heat,72,44,28,17033.0,607,342,261,0.563,1590,0.382,59,0.396,8.4,2581,533,2039,0.207,4077,0.633,414,0.705,6.3,3188,875,2300,0.274,5479,0.582,473,0.637,6.7,2019-20,Rebounding
1610612749,MIL,Milwaukee Bucks,72,55,17,16653.0,679,401,277,0.591,1591,0.427,47,0.44,7.9,3041,654,2386,0.215,4679,0.65,416,0.713,6.1,3720,1055,2663,0.284,6096,0.61,463,0.66,6.4,2019-20,Rebounding
1610612750,MIN,Minnesota Timberwolves,64,19,45,15034.0,675,415,254,0.615,1627,0.415,41,0.426,7.5,2193,526,1669,0.24,3466,0.633,308,0.694,6.2,2868,941,1923,0.328,4940,0.581,349,0.625,6.5,2019-20,Rebounding
1610612740,NOP,New Orleans Pelicans,71,30,41,16453.0,782,469,314,0.6,1851,0.422,58,0.436,7.3,2514,602,1907,0.239,4086,0.615,369,0.676,6.2,3296,1071,2221,0.325,5748,0.573,427,0.619,6.4,2019-20,Rebounding
1610612752,NYK,New York Knicks,66,21,45,15179.0,795,475,317,0.597,1764,0.451,63,0.467,7.3,2274,466,1807,0.205,3605,0.631,327,0.694,6.4,3069,941,2124,0.307,5164,0.594,390,0.643,6.6,2019-20,Rebounding
1610612760,OKC,Oklahoma City Thunder,72,44,28,16626.0,593,352,240,0.594,1429,0.415,42,0.428,7.6,2495,576,1915,0.231,4002,0.623,356,0.684,6.5,3088,928,2155,0.301,5298,0.583,398,0.63,6.7,2019-20,Rebounding
1610612753,ORL,Orlando Magic,73,33,40,16943.0,751,470,275,0.626,1702,0.441,39,0.452,6.4,2498,594,1906,0.238,4013,0.622,356,0.683,6.0,3249,1064,2181,0.327,5568,0.584,395,0.628,6.1,2019-20,Rebounding
1610612755,PHI,Philadelphia 76ers,73,43,30,16497.0,764,441,319,0.577,1845,0.414,77,0.432,7.7,2553,521,2030,0.204,3946,0.647,344,0.709,6.4,3317,962,2349,0.29,5582,0.594,421,0.643,6.7,2019-20,Rebounding
1610612756,PHX,Phoenix Suns,72,34,38,16691.0,706,387,313,0.548,1676,0.421,49,0.434,8.5,2412,533,1877,0.221,3856,0.626,330,0.684,6.2,3118,920,2190,0.295,5347,0.583,379,0.628,6.7,2019-20,Rebounding
1610612757,POR,Portland Trail Blazers,73,34,39,16847.0,749,482,261,0.644,1793,0.418,35,0.426,6.6,2561,582,1975,0.227,4163,0.615,371,0.675,6.1,3310,1064,2236,0.321,5770,0.574,406,0.617,6.2,2019-20,Rebounding
1610612758,SAC,Sacramento Kings,71,31,40,16694.0,685,408,274,0.596,1629,0.421,60,0.437,7.7,2332,544,1785,0.233,3847,0.606,351,0.667,6.3,3017,952,2059,0.316,5312,0.568,411,0.616,6.6,2019-20,Rebounding
1610612759,SAS,San Antonio Spurs,70,31,39,16055.0,630,361,266,0.573,1463,0.431,47,0.445,7.9,2477,472,2004,0.191,3924,0.631,344,0.692,6.5,3107,833,2270,0.268,5214,0.596,391,0.644,6.8,2019-20,Rebounding
1610612761,TOR,Toronto Raptors,71,52,19,16666.0,683,387,292,0.567,1697,0.402,63,0.418,7.6,2549,578,1966,0.227,4216,0.605,375,0.664,6.4,3232,965,2258,0.299,5739,0.563,438,0.61,6.6,2019-20,Rebounding
1610612762,UTA,Utah Jazz,72,44,28,16648.0,656,373,278,0.569,1540,0.426,40,0.437,7.7,2576,520,2058,0.202,4053,0.636,329,0.692,6.2,3232,893,2336,0.276,5446,0.593,369,0.637,6.5,2019-20,Rebounding
1610612764,WAS,Washington Wizards,72,25,47,16558.0,732,406,325,0.555,1717,0.426,52,0.44,7.9,2295,517,1776,0.225,3803,0.603,333,0.661,6.4,3027,923,2101,0.305,5333,0.568,385,0.612,6.7,2019-20,Rebounding
1610612737,ATL,Atlanta Hawks,72,41,31,16479.0,760,479,275,0.63,1714,0.443,37,0.453,7.1,2524,583,1934,0.231,4085,0.618,383,0.682,6.3,3284,1062,2209,0.323,5656,0.581,420,0.627,6.5,2020-21,Rebounding
1610612738,BOS,Boston Celtics,72,36,36,16397.0,765,469,293,0.613,1756,0.436,49,0.448,7.6,2420,545,1877,0.225,3912,0.619,355,0.68,6.4,3185,1014,2170,0.318,5517,0.577,404,0.623,6.7,2020-21,Rebounding
1610612751,BKN,Brooklyn Nets,72,48,24,16730.0,640,363,272,0.567,1640,0.39,61,0.405,7.9,2558,575,1974,0.225,4173,0.613,330,0.666,6.1,3198,938,2246,0.293,5636,0.567,391,0.61,6.5,2020-21,Rebounding
1610612766,CHA,Charlotte Hornets,72,33,39,16794.0,762,426,335,0.559,1825,0.418,52,0.43,8.0,2389,568,1817,0.238,3912,0.611,347,0.67,6.4,3151,994,2152,0.315,5570,0.566,399,0.609,6.7,2020-21,Rebounding
1610612741,CHI,Chicago Bulls,72,31,41,16899.0,693,414,276,0.597,1646,0.421,50,0.434,7.4,2544,571,1969,0.224,4000,0.636,364,0.7,6.0,3237,985,2245,0.304,5471,0.592,414,0.64,6.3,2020-21,Rebounding
1610612739,CLE,Cleveland Cavaliers,72,22,50,16597.0,751,455,295,0.606,1793,0.419,50,0.431,7.0,2327,585,1737,0.251,3669,0.634,318,0.694,6.3,3078,1040,2032,0.338,5301,0.581,368,0.624,6.5,2020-21,Rebounding
1610612742,DAL,Dallas Mavericks,72,42,30,16400.0,657,373,278,0.568,1478,0.445,40,0.457,7.6,2462,510,1949,0.207,3892,0.633,370,0.699,6.2,3119,883,2227,0.283,5202,0.6,410,0.651,6.5,2020-21,Rebounding
1610612743,DEN,Denver Nuggets,72,47,25,16690.0,754,457,294,0.606,1775,0.425,47,0.436,6.6,2439,573,1850,0.235,3799,0.642,328,0.703,6.1,3193,1030,2144,0.323,5398,0.592,375,0.636,6.2,2020-21,Rebounding
1610612765,DET,Detroit Pistons,72,20,52,16530.0,690,391,282,0.567,1784,0.387,45,0.397,7.1,2363,496,1845,0.21,3817,0.619,366,0.685,6.6,3053,887,2127,0.291,5408,0.565,411,0.611,6.7,2020-21,Rebounding
1610612744,GSW,Golden State Warriors,72,39,33,16539.0,573,348,216,0.607,1355,0.423,41,0.436,7.5,2522,557,1949,0.221,4220,0.598,427,0.665,6.3,3095,905,2165,0.292,5408,0.572,468,0.627,6.5,2020-21,Rebounding
1610612745,HOU,Houston Rockets,72,17,55,16531.0,667,392,266,0.588,1673,0.399,51,0.411,8.4,2387,547,1813,0.229,3857,0.619,343,0.679,6.4,3054,939,2079,0.307,5372,0.569,394,0.613,6.9,2020-21,Rebounding
1610612754,IND,Indiana Pacers,72,34,38,16789.0,648,369,275,0.569,1664,0.389,49,0.401,7.4,2424,509,1914,0.21,4049,0.599,366,0.658,6.2,3072,878,2189,0.286,5560,0.553,415,0.597,6.4,2020-21,Rebounding
1610612746,LAC,LA Clippers,72,47,25,16386.0,675,410,252,0.607,1589,0.425,54,0.44,7.5,2491,581,1904,0.233,3966,0.628,361,0.691,6.6,3166,991,2156,0.313,5400,0.586,415,0.635,6.7,2020-21,Rebounding
1610612747,LAL,Los Angeles Lakers,72,42,30,16731.0,693,420,272,0.606,1562,0.444,31,0.453,7.1,2490,495,1991,0.199,3944,0.631,334,0.69,6.3,3183,915,2263,0.287,5296,0.601,365,0.646,6.5,2020-21,Rebounding
1610612763,MEM,Memphis Grizzlies,72,38,34,16679.0,803,480,318,0.598,1819,0.441,41,0.452,7.2,2543,610,1928,0.24,4002,0.635,351,0.697,5.9,3346,1090,2246,0.326,5645,0.593,392,0.637,6.2,2020-21,Rebounding
1610612748,MIA,Miami Heat,72,40,32,16615.0,579,326,251,0.563,1478,0.392,44,0.404,8.6,2408,515,1889,0.214,3991,0.603,380,0.667,6.6,2987,841,2140,0.282,5319,0.562,424,0.61,7.0,2020-21,Rebounding
1610612749,MIL,Milwaukee Bucks,72,46,26,16475.0,741,425,311,0.574,1639,0.452,53,0.467,7.9,2724,594,2126,0.218,4268,0.638,360,0.697,6.3,3465,1019,2437,0.294,5759,0.602,413,0.648,6.6,2020-21,Rebounding
1610612750,MIN,Minnesota Timberwolves,72,23,49,16613.0,757,445,312,0.588,1837,0.412,60,0.426,7.7,2376,586,1792,0.247,3850,0.617,346,0.678,6.1,3133,1031,2104,0.329,5513,0.568,406,0.613,6.5,2020-21,Rebounding
1610612740,NOP,New Orleans Pelicans,72,31,41,16809.0,845,553,288,0.654,1913,0.442,58,0.456,6.6,2562,589,1965,0.23,4038,0.634,343,0.693,6.2,3407,1142,2253,0.335,5792,0.588,401,0.632,6.3,2020-21,Rebounding
1610612752,NYK,New York Knicks,72,41,31,16837.0,696,415,263,0.596,1712,0.407,59,0.421,7.7,2554,540,1991,0.211,4070,0.628,361,0.689,6.5,3250,955,2254,0.294,5616,0.579,420,0.625,6.7,2020-21,Rebounding
1610612760,OKC,Oklahoma City Thunder,72,22,50,16834.0,715,417,284,0.583,1668,0.429,47,0.441,7.4,2562,604,1936,0.236,4000,0.641,339,0.7,6.1,3277,1021,2220,0.312,5509,0.595,386,0.64,6.4,2020-21,Rebounding
1610612753,ORL,Orlando Magic,72,21,51,16740.0,747,463,283,0.62,1754,0.426,67,0.443,6.9,2525,573,1949,0.227,3932,0.642,373,0.709,6.1,3272,1036,2232,0.317,5556,0.589,440,0.64,6.3,2020-21,Rebounding
1610612755,PHI,Philadelphia 76ers,72,49,23,16212.0,722,452,266,0.626,1653,0.437,52,0.451,6.9,2522,560,1956,0.222,3950,0.638,342,0.699,6.3,3244,1012,2222,0.312,5433,0.597,394,0.644,6.4,2020-21,Rebounding
1610612756,PHX,Phoenix Suns,72,51,21,16735.0,630,367,255,0.583,1419,0.444,40,0.457,7.9,2461,539,1895,0.219,3918,0.628,388,0.697,6.4,3091,906,2150,0.293,5197,0.595,428,0.648,6.7,2020-21,Rebounding
1610612757,POR,Portland Trail Blazers,72,42,30,16627.0,766,505,255,0.659,1846,0.415,64,0.43,6.7,2441,564,1873,0.231,3774,0.647,330,0.709,6.0,3207,1069,2128,0.333,5465,0.587,394,0.632,6.2,2020-21,Rebounding
1610612758,SAC,Sacramento Kings,72,31,41,16467.0,674,389,278,0.577,1591,0.424,41,0.435,7.7,2306,570,1735,0.247,3760,0.613,362,0.679,6.3,2980,959,2013,0.322,5199,0.573,403,0.621,6.6,2020-21,Rebounding
1610612759,SAS,San Antonio Spurs,72,33,39,16567.0,669,402,264,0.601,1555,0.43,51,0.445,7.2,2489,607,1880,0.244,3833,0.649,326,0.71,5.9,3158,1009,2144,0.32,5222,0.605,377,0.652,6.2,2020-21,Rebounding
1610612761,TOR,Toronto Raptors,72,27,45,16534.0,680,399,274,0.587,1707,0.398,55,0.412,7.5,2314,533,1778,0.23,3910,0.592,353,0.651,6.4,2994,932,2052,0.311,5476,0.547,408,0.591,6.6,2020-21,Rebounding
1610612762,UTA,Utah Jazz,72,52,20,16676.0,765,428,337,0.559,1733,0.441,52,0.455,7.7,2707,537,2161,0.198,4294,0.63,397,0.695,6.2,3472,965,2498,0.278,5889,0.59,449,0.638,6.5,2020-21,Rebounding
1610612764,WAS,Washington Wizards,72,34,38,16498.0,697,402,296,0.577,1697,0.411,55,0.424,7.2,2557,566,1983,0.221,4022,0.636,336,0.694,6.0,3254,968,2279,0.297,5529,0.589,391,0.633,6.3,2020-21,Rebounding
1610612737,ATL,Atlanta Hawks,82,43,39,18963.0,822,481,338,0.585,1808,0.455,50,0.468,7.1,2783,616,2163,0.221,4449,0.626,377,0.683,6.3,3605,1097,2501,0.304,6099,0.591,427,0.636,6.5,2021-22,Rebounding
1610612738,BOS,Boston Celtics,81,51,30,19025.0,855,505,348,0.591,1953,0.438,76,0.456,8.0,2885,689,2193,0.239,4566,0.632,409,0.694,6.4,3740,1194,2541,0.319,6364,0.588,485,0.636,6.8,2021-22,Rebounding
1610612751,BKN,Brooklyn Nets,82,44,38,18942.0,844,540,300,0.64,2029,0.416,53,0.427,6.9,2796,642,2153,0.23,4557,0.614,409,0.674,6.4,3640,1182,2453,0.325,6418,0.567,462,0.611,6.5,2021-22,Rebounding
1610612766,CHA,Charlotte Hornets,81,43,38,19178.0,881,463,418,0.526,2077,0.424,84,0.442,8.2,2746,657,2087,0.239,4523,0.607,409,0.667,6.3,3627,1120,2505,0.309,6406,0.566,493,0.613,6.8,2021-22,Rebounding
1610612741,CHI,Chicago Bulls,82,46,36,18950.0,711,424,286,0.596,1816,0.392,58,0.404,7.7,2759,635,2117,0.23,4353,0.634,384,0.695,6.0,3470,1059,2403,0.305,5999,0.578,442,0.624,6.4,2021-22,Rebounding
1610612739,CLE,Cleveland Cavaliers,82,44,38,18879.0,837,500,335,0.597,1944,0.431,69,0.446,7.4,2785,660,2121,0.237,4553,0.612,416,0.673,6.2,3622,1160,2456,0.32,6337,0.572,485,0.619,6.5,2021-22,Rebounding
1610612742,DAL,Dallas Mavericks,82,52,30,19072.0,759,398,359,0.524,1880,0.404,82,0.422,8.8,2769,644,2114,0.233,4547,0.609,444,0.675,6.2,3528,1042,2473,0.295,6202,0.569,526,0.622,6.8,2021-22,Rebounding
1610612743,DEN,Denver Nuggets,82,48,34,18673.0,752,471,274,0.626,1749,0.43,56,0.444,7.1,2863,669,2185,0.234,4312,0.664,349,0.722,5.9,3615,1140,2459,0.315,5859,0.617,405,0.663,6.2,2021-22,Rebounding
1610612765,DET,Detroit Pistons,81,23,58,18837.0,890,517,369,0.581,2158,0.412,72,0.427,7.7,2596,573,2017,0.221,4253,0.61,369,0.668,6.2,3486,1090,2386,0.313,6216,0.561,441,0.604,6.5,2021-22,Rebounding
1610612744,GSW,Golden State Warriors,81,53,28,18907.0,792,459,332,0.58,1860,0.426,52,0.438,7.6,2893,677,2210,0.234,4725,0.612,440,0.675,6.1,3685,1136,2542,0.308,6379,0.578,492,0.626,6.4,2021-22,Rebounding
1610612745,HOU,Houston Rockets,82,20,62,18764.0,786,474,305,0.603,1949,0.403,61,0.416,7.8,2660,599,2053,0.225,4272,0.623,359,0.68,6.2,3446,1073,2358,0.311,6010,0.573,420,0.616,6.6,2021-22,Rebounding
1610612754,IND,Indiana Pacers,82,25,57,18944.0,925,557,368,0.602,2167,0.427,71,0.441,7.1,2671,586,2077,0.219,4457,0.599,407,0.66,6.3,3596,1143,2445,0.318,6443,0.558,478,0.603,6.5,2021-22,Rebounding
1610612746,LAC,LA Clippers,81,42,39,18811.0,739,439,291,0.594,1798,0.411,51,0.423,7.1,2819,652,2155,0.231,4550,0.62,421,0.683,6.3,3558,1091,2446,0.307,6190,0.575,472,0.622,6.4,2021-22,Rebounding
1610612747,LAL,Los Angeles Lakers,82,33,49,19177.0,782,453,325,0.579,1883,0.415,50,0.427,7.2,2826,641,2178,0.227,4445,0.636,332,0.687,6.4,3608,1094,2503,0.303,6063,0.595,382,0.635,6.5,2021-22,Rebounding
1610612763,MEM,Memphis Grizzlies,81,55,26,18668.0,1141,698,436,0.612,2547,0.448,94,0.465,7.1,2830,640,2180,0.226,4414,0.641,392,0.704,6.2,3971,1338,2616,0.337,6753,0.588,486,0.634,6.4,2021-22,Rebounding
1610612748,MIA,Miami Heat,82,53,29,19143.0,807,461,343,0.571,1998,0.404,64,0.417,7.8,2778,607,2162,0.219,4619,0.601,483,0.672,6.4,3585,1068,2505,0.298,6455,0.555,547,0.607,6.7,2021-22,Rebounding
1610612749,MIL,Milwaukee Bucks,82,51,31,19015.0,840,503,337,0.599,1973,0.426,60,0.439,7.6,2989,644,2340,0.215,4727,0.632,416,0.693,6.2,3829,1147,2677,0.3,6523,0.587,476,0.633,6.5,2021-22,Rebounding
1610612750,MIN,Minnesota Timberwolves,82,46,36,18757.0,920,527,388,0.573,2087,0.441,60,0.454,7.7,2700,601,2097,0.223,4321,0.625,380,0.685,6.4,3620,1128,2485,0.312,6223,0.582,440,0.626,6.7,2021-22,Rebounding
1610612740,NOP,New Orleans Pelicans,81,35,46,18661.0,973,562,406,0.578,2186,0.445,72,0.46,7.7,2688,593,2087,0.221,4266,0.63,358,0.688,6.2,3661,1155,2493,0.315,6274,0.584,430,0.626,6.6,2021-22,Rebounding
1610612752,NYK,New York Knicks,81,36,45,18751.0,930,557,370,0.599,2078,0.448,56,0.46,7.6,2810,650,2156,0.231,4568,0.615,391,0.673,6.3,3740,1207,2526,0.323,6446,0.58,447,0.623,6.6,2021-22,Rebounding
1610612760,OKC,Oklahoma City Thunder,82,24,58,19082.0,854,477,374,0.559,2066,0.413,72,0.428,7.8,2886,678,2205,0.235,4627,0.624,393,0.682,6.0,3740,1155,2579,0.309,6526,0.573,465,0.617,6.4,2021-22,Rebounding
1610612753,ORL,Orlando Magic,82,22,60,18812.0,746,438,305,0.587,1882,0.396,54,0.408,7.6,2884,624,2248,0.216,4617,0.625,432,0.689,6.2,3630,1062,2553,0.293,6312,0.575,486,0.623,6.5,2021-22,Rebounding
1610612755,PHI,Philadelphia 76ers,82,51,31,18557.0,699,428,267,0.612,1715,0.408,48,0.419,7.2,2770,598,2163,0.216,4400,0.63,379,0.689,6.4,3469,1026,2430,0.296,5926,0.585,427,0.631,6.6,2021-22,Rebounding
1610612756,PHX,Phoenix Suns,81,63,18,18743.0,780,475,299,0.609,1754,0.445,52,0.458,7.6,2871,673,2193,0.234,4532,0.633,386,0.692,6.3,3651,1148,2492,0.314,6100,0.599,438,0.645,6.6,2021-22,Rebounding
1610612757,POR,Portland Trail Blazers,82,27,55,18817.0,854,493,362,0.577,2098,0.407,78,0.423,8.1,2661,562,2091,0.211,4332,0.614,370,0.672,6.3,3515,1055,2453,0.3,6213,0.566,448,0.61,6.7,2021-22,Rebounding
1610612758,SAC,Sacramento Kings,81,29,52,18876.0,771,444,320,0.576,1894,0.407,60,0.42,7.4,2691,551,2134,0.205,4373,0.615,407,0.679,6.2,3462,995,2454,0.287,6087,0.569,467,0.616,6.5,2021-22,Rebounding
1610612759,SAS,San Antonio Spurs,82,34,48,18889.0,901,552,343,0.613,2089,0.431,70,0.446,7.0,2815,691,2123,0.245,4679,0.602,431,0.663,6.0,3716,1243,2466,0.334,6585,0.564,501,0.611,6.3,2021-22,Rebounding
1610612761,TOR,Toronto Raptors,82,48,34,19142.0,1095,668,422,0.61,2393,0.458,82,0.474,7.2,2621,587,2026,0.224,4287,0.611,399,0.674,6.4,3716,1255,2448,0.338,6512,0.571,481,0.616,6.6,2021-22,Rebounding
1610612762,UTA,Utah Jazz,82,49,33,18975.0,884,528,354,0.597,2016,0.438,60,0.452,7.4,2916,635,2278,0.218,4652,0.627,401,0.686,6.1,3800,1163,2632,0.306,6506,0.584,461,0.629,6.4,2021-22,Rebounding
1610612764,WAS,Washington Wizards,82,35,47,19144.0,737,431,302,0.585,1796,0.41,56,0.424,7.4,2797,590,2200,0.211,4507,0.621,454,0.69,6.1,3534,1021,2502,0.289,6135,0.576,510,0.628,6.4,2021-22,Rebounding
1610612737,ATL,Atlanta Hawks,82,41,41,18838.0,920,544,371,0.591,2033,0.453,45,0.463,7.6,2719,707,2011,0.26,4336,0.627,387,0.689,6.1,3639,1251,2382,0.344,6202,0.587,432,0.631,6.5,2022-23,Rebounding
1610612738,BOS,Boston Celtics,82,57,25,19408.0,796,431,360,0.541,1789,0.445,63,0.461,8.3,2921,693,2229,0.237,4715,0.62,460,0.686,6.4,3717,1124,2589,0.302,6321,0.588,523,0.641,6.8,2022-23,Rebounding
1610612751,BKN,Brooklyn Nets,82,45,37,18501.0,674,367,304,0.545,1575,0.428,55,0.443,8.0,2648,591,2045,0.223,4469,0.593,379,0.647,6.4,3322,958,2349,0.288,5844,0.568,434,0.614,6.8,2022-23,Rebounding
1610612766,CHA,Charlotte Hornets,82,27,55,19215.0,901,544,348,0.604,2177,0.414,68,0.427,7.2,2750,631,2101,0.229,4507,0.61,412,0.672,6.4,3651,1175,2449,0.322,6504,0.561,480,0.606,6.6,2022-23,Rebounding
1610612741,CHI,Chicago Bulls,81,39,42,18552.0,683,416,264,0.609,1645,0.415,56,0.43,7.6,2742,631,2106,0.23,4365,0.628,362,0.685,6.3,3425,1047,2370,0.306,5811,0.589,418,0.635,6.5,2022-23,Rebounding
1610612739,CLE,Cleveland Cavaliers,82,51,31,18725.0,795,477,319,0.6,1801,0.441,54,0.455,7.7,2574,657,1912,0.255,4188,0.615,367,0.674,6.4,3369,1134,2231,0.337,5824,0.578,421,0.624,6.7,2022-23,Rebounding
1610612742,DAL,Dallas Mavericks,82,38,44,18988.0,625,323,302,0.517,1630,0.383,48,0.395,8.9,2556,594,1961,0.232,4179,0.612,361,0.669,6.2,3181,917,2263,0.288,5599,0.568,409,0.613,6.7,2022-23,Rebounding
1610612743,DEN,Denver Nuggets,82,53,29,18697.0,828,507,319,0.612,1822,0.454,55,0.469,7.0,2699,678,2020,0.251,4266,0.633,342,0.688,6.1,3527,1185,2339,0.336,5882,0.6,397,0.643,6.3,2022-23,Rebounding
1610612765,DET,Detroit Pistons,81,17,64,18831.0,898,514,383,0.572,2140,0.42,60,0.432,7.6,2532,556,1965,0.22,4213,0.601,366,0.658,6.2,3430,1070,2348,0.312,6127,0.56,426,0.602,6.6,2022-23,Rebounding
1610612744,GSW,Golden State Warriors,81,43,38,18695.0,852,490,363,0.575,1879,0.453,54,0.467,7.7,2750,647,2100,0.235,4581,0.6,407,0.659,6.3,3602,1137,2463,0.316,6247,0.577,461,0.623,6.6,2022-23,Rebounding
1610612745,HOU,Houston Rockets,82,22,60,18795.0,1100,662,435,0.602,2512,0.438,84,0.453,7.1,2695,664,2030,0.246,4251,0.634,349,0.691,6.2,3795,1326,2465,0.349,6567,0.578,433,0.619,6.5,2022-23,Rebounding
1610612754,IND,Indiana Pacers,82,35,47,19155.0,832,454,375,0.546,2121,0.392,59,0.403,8.2,2575,589,1985,0.229,4455,0.578,456,0.644,6.6,3407,1043,2360,0.306,6388,0.533,515,0.58,7.0,2022-23,Rebounding
1610612746,LAC,LA Clippers,82,44,38,18811.0,803,473,330,0.589,1856,0.433,59,0.447,7.7,2742,664,2076,0.242,4423,0.62,390,0.68,6.1,3545,1137,2406,0.321,6065,0.585,449,0.631,6.5,2022-23,Rebounding
1610612747,LAL,Los Angeles Lakers,82,43,39,19101.0,818,491,323,0.6,1851,0.442,62,0.457,7.1,2930,747,2173,0.255,4634,0.632,425,0.696,6.3,3748,1238,2496,0.33,6295,0.595,487,0.645,6.4,2022-23,Rebounding
1610612763,MEM,Memphis Grizzlies,82,51,31,19110.0,988,559,427,0.566,2287,0.432,65,0.445,7.3,2835,652,2174,0.23,4700,0.603,381,0.656,6.3,3823,1211,2601,0.317,6773,0.564,446,0.604,6.6,2022-23,Rebounding
1610612748,MIA,Miami Heat,82,44,38,19028.0,796,443,356,0.557,1896,0.42,56,0.433,8.1,2533,582,1948,0.23,4289,0.591,431,0.657,6.7,3329,1025,2304,0.308,6015,0.553,487,0.602,7.1,2022-23,Rebounding
1610612749,MIL,Milwaukee Bucks,82,58,24,18972.0,913,496,419,0.543,2087,0.437,78,0.454,8.5,3073,658,2406,0.214,4862,0.632,434,0.694,6.3,3986,1154,2825,0.29,6735,0.592,512,0.641,6.8,2022-23,Rebounding
1610612750,MIN,Minnesota Timberwolves,81,41,40,18245.0,738,421,318,0.57,1721,0.429,30,0.436,8.2,2652,598,2053,0.225,4343,0.611,358,0.665,6.3,3390,1019,2371,0.301,5855,0.579,388,0.62,6.7,2022-23,Rebounding
1610612740,NOP,New Orleans Pelicans,82,42,40,19060.0,866,507,359,0.585,2028,0.427,66,0.441,7.5,2717,671,2045,0.247,4360,0.623,371,0.681,6.2,3583,1178,2404,0.329,6180,0.58,437,0.624,6.5,2022-23,Rebounding
1610612752,NYK,New York Knicks,82,47,35,19139.0,1031,627,403,0.608,2290,0.45,76,0.466,7.2,2790,640,2142,0.229,4474,0.624,361,0.678,6.2,3821,1267,2545,0.332,6545,0.584,437,0.626,6.4,2022-23,Rebounding
1610612760,OKC,Oklahoma City Thunder,82,40,42,19012.0,934,525,409,0.562,2239,0.417,88,0.434,7.8,2645,629,2011,0.238,4498,0.588,434,0.651,6.3,3579,1154,2420,0.322,6511,0.55,522,0.598,6.7,2022-23,Rebounding
1610612753,ORL,Orlando Magic,82,34,48,18908.0,833,475,357,0.57,2025,0.411,58,0.423,7.9,2713,578,2133,0.213,4353,0.623,404,0.687,6.4,3546,1053,2490,0.297,6187,0.573,462,0.619,6.8,2022-23,Rebounding
1610612755,PHI,Philadelphia 76ers,82,54,28,18907.0,715,421,295,0.589,1744,0.41,56,0.424,7.9,2641,565,2073,0.214,4319,0.611,384,0.671,6.3,3356,986,2368,0.294,5869,0.572,440,0.618,6.6,2022-23,Rebounding
1610612756,PHX,Phoenix Suns,82,45,37,19033.0,971,577,391,0.594,2192,0.443,68,0.457,7.5,2657,577,2079,0.217,4312,0.616,383,0.676,6.4,3628,1154,2470,0.318,6291,0.577,451,0.621,6.7,2022-23,Rebounding
1610612757,POR,Portland Trail Blazers,81,33,48,18705.0,766,421,341,0.55,1883,0.407,72,0.423,8.4,2523,581,1942,0.23,4132,0.611,375,0.672,6.2,3289,1002,2283,0.305,5822,0.565,447,0.612,6.7,2022-23,Rebounding
1610612758,SAC,Sacramento Kings,82,48,34,18488.0,782,439,345,0.561,1885,0.415,70,0.431,7.8,2698,608,2090,0.225,4233,0.637,360,0.697,6.0,3480,1047,2435,0.301,5928,0.587,430,0.633,6.4,2022-23,Rebounding
1610612759,SAS,San Antonio Spurs,79,21,58,18433.0,930,539,388,0.58,2149,0.433,66,0.446,7.2,2524,591,1935,0.234,4175,0.605,399,0.668,6.1,3454,1130,2323,0.327,6107,0.566,465,0.612,6.4,2022-23,Rebounding
1610612761,TOR,Toronto Raptors,82,41,41,19067.0,1043,664,379,0.637,2338,0.446,88,0.464,6.8,2485,586,1895,0.236,3984,0.624,369,0.687,6.4,3528,1250,2274,0.354,6147,0.574,457,0.62,6.5,2022-23,Rebounding
1610612762,UTA,Utah Jazz,82,37,45,18862.0,968,570,397,0.589,2193,0.441,61,0.454,7.4,2794,643,2149,0.23,4479,0.624,359,0.678,6.2,3762,1213,2546,0.322,6458,0.583,420,0.623,6.5,2022-23,Rebounding
1610612764,WAS,Washington Wizards,82,35,47,19109.0,774,466,304,0.602,1786,0.433,47,0.445,7.2,2804,653,2150,0.233,4519,0.62,406,0.682,5.9,3578,1119,2454,0.313,6125,0.584,453,0.631,6.2,2022-23,Rebounding
1610612737,ATL,Atlanta Hawks,82,36,46,18991.0,1023,546,454,0.534,2191,0.467,74,0.483,7.6,2632,599,1982,0.228,4213,0.625,363,0.684,6.6,3655,1145,2436,0.313,6265,0.583,437,0.627,6.9,2023-24,Rebounding
1610612738,BOS,Boston Celtics,81,63,18,19061.0,863,455,404,0.527,2013,0.429,91,0.449,8.5,2893,647,2220,0.224,4764,0.607,462,0.672,6.6,3756,1102,2624,0.293,6636,0.566,553,0.617,7.0,2023-24,Rebounding
1610612751,BKN,Brooklyn Nets,79,32,47,18497.0,904,477,419,0.528,2043,0.442,83,0.461,8.1,2581,561,1987,0.217,4406,0.586,418,0.647,6.8,3485,1038,2406,0.298,6335,0.55,501,0.597,7.2,2023-24,Rebounding
1610612766,CHA,Charlotte Hornets,81,20,61,18471.0,756,420,331,0.556,1770,0.427,50,0.44,7.9,2502,540,1924,0.216,4179,0.599,362,0.655,6.5,3258,960,2255,0.295,5806,0.561,412,0.604,6.8,2023-24,Rebounding
1610612741,CHI,Chicago Bulls,81,39,42,18579.0,899,506,378,0.563,1956,0.46,51,0.472,7.8,2635,573,1994,0.217,4227,0.623,373,0.684,6.6,3534,1079,2372,0.305,6008,0.588,424,0.633,6.9,2023-24,Rebounding
1610612739,CLE,Cleveland Cavaliers,82,48,34,19015.0,807,426,375,0.528,1795,0.45,49,0.462,8.0,2740,620,2075,0.226,4477,0.612,417,0.675,6.9,3547,1046,2450,0.295,6118,0.58,466,0.628,7.1,2023-24,Rebounding
1610612742,DAL,Dallas Mavericks,81,49,32,18574.0,791,375,415,0.474,1961,0.403,86,0.422,8.7,2682,597,2036,0.223,4472,0.6,394,0.658,7.0,3473,972,2451,0.28,6231,0.557,480,0.604,7.4,2023-24,Rebounding
1610612743,DEN,Denver Nuggets,80,55,25,18051.0,868,545,315,0.628,1833,0.474,52,0.487,6.7,2698,708,1952,0.262,4196,0.643,352,0.702,6.3,3566,1253,2267,0.351,5863,0.608,404,0.653,6.4,2023-24,Rebounding
1610612765,DET,Detroit Pistons,81,14,67,18781.0,841,469,360,0.558,1984,0.424,54,0.436,7.9,2655,547,2068,0.206,4332,0.613,385,0.673,6.3,3496,1016,2428,0.291,6139,0.569,439,0.613,6.7,2023-24,Rebounding
1610612744,GSW,Golden State Warriors,81,46,35,18660.0,976,542,427,0.555,2197,0.444,84,0.462,7.6,2778,632,2103,0.228,4587,0.606,429,0.668,6.5,3754,1174,2530,0.313,6626,0.567,513,0.614,6.8,2023-24,Rebounding
1610612745,HOU,Houston Rockets,82,41,41,18997.0,940,534,390,0.568,2180,0.431,86,0.449,7.7,2783,631,2088,0.227,4500,0.618,426,0.683,6.3,3723,1165,2478,0.313,6494,0.573,512,0.622,6.6,2023-24,Rebounding
1610612754,IND,Indiana Pacers,82,47,35,18579.0,826,425,395,0.515,1998,0.413,81,0.431,8.2,2577,560,1969,0.217,4269,0.604,387,0.664,6.5,3403,985,2364,0.289,6077,0.56,468,0.607,6.9,2023-24,Rebounding
1610612746,LAC,LA Clippers,81,50,31,18533.0,812,470,334,0.579,1851,0.439,63,0.454,7.2,2649,598,1999,0.226,4226,0.627,372,0.687,6.9,3461,1068,2333,0.309,5916,0.585,435,0.631,7.0,2023-24,Rebounding
1610612747,LAL,Los Angeles Lakers,81,46,35,18248.0,660,379,269,0.574,1468,0.45,39,0.462,7.8,2788,640,2085,0.23,4369,0.638,348,0.693,6.5,3448,1019,2354,0.296,5727,0.602,387,0.646,6.8,2023-24,Rebounding
1610612763,MEM,Memphis Grizzlies,82,27,55,19144.0,895,447,443,0.499,2134,0.419,74,0.434,8.3,2591,521,2032,0.201,4403,0.588,410,0.649,6.7,3486,968,2475,0.278,6346,0.549,484,0.595,7.1,2023-24,Rebounding
1610612748,MIA,Miami Heat,81,46,35,18711.0,755,408,342,0.54,1739,0.434,54,0.448,7.9,2666,580,2052,0.218,4348,0.613,415,0.678,6.8,3421,988,2394,0.289,5950,0.575,469,0.624,7.0,2023-24,Rebounding
1610612749,MIL,Milwaukee Bucks,82,49,33,18953.0,772,411,353,0.532,1727,0.447,52,0.461,8.2,2849,606,2207,0.213,4608,0.618,382,0.674,6.7,3621,1017,2560,0.281,6177,0.586,434,0.631,7.1,2023-24,Rebounding
1610612750,MIN,Minnesota Timberwolves,82,56,26,18541.0,770,420,341,0.545,1792,0.43,51,0.442,7.7,2806,649,2127,0.231,4496,0.624,402,0.685,6.4,3576,1069,2468,0.299,6121,0.584,453,0.631,6.7,2023-24,Rebounding
1610612740,NOP,New Orleans Pelicans,81,49,32,18791.0,839,469,365,0.559,1980,0.424,65,0.438,7.7,2721,592,2090,0.218,4483,0.607,419,0.67,6.9,3560,1061,2455,0.298,6300,0.565,484,0.612,7.1,2023-24,Rebounding
1610612752,NYK,New York Knicks,82,50,32,18931.0,1038,604,421,0.582,2403,0.432,85,0.448,7.8,2658,641,1970,0.241,4366,0.609,432,0.676,6.3,3696,1245,2391,0.337,6614,0.559,517,0.606,6.7,2023-24,Rebounding
1610612760,OKC,Oklahoma City Thunder,82,57,25,18892.0,722,408,310,0.565,1796,0.402,69,0.418,8.2,2725,691,1989,0.254,4570,0.596,444,0.66,6.5,3447,1099,2299,0.319,6243,0.552,513,0.602,6.9,2023-24,Rebounding
1610612753,ORL,Orlando Magic,82,47,35,18608.0,859,480,368,0.559,2119,0.405,83,0.422,7.6,2606,538,2019,0.206,4227,0.617,399,0.681,6.5,3465,1018,2387,0.294,6171,0.561,482,0.609,6.8,2023-24,Rebounding
1610612755,PHI,Philadelphia 76ers,81,46,35,18694.0,893,545,343,0.61,2129,0.419,75,0.435,7.5,2568,566,1946,0.22,4308,0.596,382,0.654,6.5,3461,1111,2289,0.321,6303,0.549,457,0.592,6.8,2023-24,Rebounding
1610612756,PHX,Phoenix Suns,80,48,32,18444.0,812,449,360,0.553,1935,0.42,81,0.438,8.7,2715,610,2059,0.225,4446,0.611,389,0.669,6.8,3527,1059,2419,0.3,6234,0.566,470,0.612,7.3,2023-24,Rebounding
1610612757,POR,Portland Trail Blazers,81,20,61,19093.0,1018,582,430,0.572,2376,0.428,76,0.443,7.4,2435,531,1862,0.218,4090,0.595,345,0.65,6.5,3453,1113,2292,0.322,6294,0.549,421,0.588,6.8,2023-24,Rebounding
1610612758,SAC,Sacramento Kings,82,46,36,18821.0,888,439,442,0.494,2065,0.43,79,0.447,8.5,2711,578,2084,0.213,4374,0.62,413,0.684,6.7,3599,1017,2526,0.283,6283,0.573,492,0.621,7.2,2023-24,Rebounding
1610612759,SAS,San Antonio Spurs,81,21,60,18366.0,836,453,374,0.542,1896,0.441,64,0.456,8.2,2737,588,2109,0.215,4384,0.624,356,0.679,6.8,3573,1041,2483,0.291,6133,0.583,420,0.625,7.2,2023-24,Rebounding
1610612761,TOR,Toronto Raptors,81,25,56,18596.0,882,517,358,0.586,1976,0.446,79,0.465,7.6,2572,557,1975,0.217,4161,0.618,361,0.677,6.8,3454,1074,2333,0.311,5998,0.576,440,0.621,7.0,2023-24,Rebounding
1610612762,UTA,Utah Jazz,81,31,50,18721.0,987,563,416,0.57,2278,0.433,86,0.45,7.8,2702,647,2000,0.239,4360,0.62,413,0.685,6.6,3689,1210,2416,0.328,6484,0.569,499,0.616,6.9,2023-24,Rebounding
1610612764,WAS,Washington Wizards,82,15,67,18501.0,752,416,333,0.553,1857,0.405,49,0.416,7.8,2607,557,2000,0.214,4350,0.599,389,0.658,6.6,3359,973,2333,0.29,6010,0.559,438,0.603,6.9,2023-24,Rebounding
1610612737,ATL,Atlanta Hawks,82,40,42,18926.0,974,565,403,0.58,2107,0.462,72,0.479,7.0,2675,628,2030,0.235,4356,0.614,388,0.674,6.3,3649,1193,2433,0.327,6309,0.578,460,0.624,6.5,2024-25,Rebounding
1610612738,BOS,Boston Celtics,82,61,21,19118.0,922,488,430,0.529,2075,0.444,76,0.461,8.8,2761,712,2031,0.258,4607,0.599,439,0.662,6.5,3683,1200,2461,0.326,6555,0.562,515,0.61,7.0,2024-25,Rebounding
1610612751,BKN,Brooklyn Nets,82,26,56,19171.0,894,484,405,0.541,2172,0.412,81,0.428,8.0,2493,621,1866,0.249,4171,0.598,418,0.664,6.3,3387,1105,2271,0.326,6169,0.549,499,0.597,6.7,2024-25,Rebounding
1610612766,CHA,Charlotte Hornets,82,19,63,18764.0,1002,566,430,0.565,2391,0.419,91,0.436,7.8,2702,642,2050,0.238,4488,0.602,443,0.668,6.4,3704,1208,2480,0.326,6702,0.553,534,0.601,6.8,2024-25,Rebounding
1610612741,CHI,Chicago Bulls,82,39,43,18879.0,825,450,374,0.545,1846,0.447,60,0.462,8.3,2935,720,2200,0.245,4778,0.614,441,0.677,6.4,3760,1170,2574,0.311,6457,0.582,501,0.631,6.8,2024-25,Rebounding
1610612739,CLE,Cleveland Cavaliers,82,64,18,18742.0,917,474,439,0.517,2120,0.433,86,0.451,8.9,2805,731,2069,0.261,4670,0.601,450,0.665,6.4,3722,1205,2508,0.324,6620,0.562,536,0.612,7.0,2024-25,Rebounding
1610612742,DAL,Dallas Mavericks,82,39,43,18905.0,828,456,369,0.551,1932,0.429,79,0.447,7.6,2701,678,2017,0.251,4582,0.589,472,0.657,6.6,3529,1134,2386,0.321,6349,0.556,551,0.609,6.8,2024-25,Rebounding
1610612743,DEN,Denver Nuggets,81,50,31,18852.0,906,568,334,0.627,1964,0.461,66,0.477,6.9,2806,734,2064,0.262,4508,0.622,434,0.689,6.3,3712,1302,2398,0.351,6299,0.589,500,0.64,6.5,2024-25,Rebounding
1610612765,DET,Detroit Pistons,82,44,38,18625.0,931,510,412,0.548,2192,0.425,67,0.438,7.4,2739,637,2090,0.233,4522,0.606,449,0.672,6.5,3670,1147,2502,0.313,6507,0.564,516,0.613,6.7,2024-25,Rebounding
1610612744,GSW,Golden State Warriors,82,48,34,19132.0,1029,545,476,0.53,2386,0.431,96,0.449,7.9,2692,672,2004,0.25,4503,0.598,441,0.663,6.3,3721,1217,2480,0.327,6683,0.557,537,0.605,6.7,2024-25,Rebounding
1610612745,HOU,Houston Rockets,82,52,30,18967.0,1200,695,500,0.579,2704,0.444,104,0.462,7.3,2774,707,2061,0.255,4526,0.613,404,0.673,6.2,3974,1402,2561,0.353,7018,0.566,508,0.61,6.6,2024-25,Rebounding
1610612754,IND,Indiana Pacers,82,50,32,19063.0,752,413,338,0.549,1764,0.426,50,0.439,8.2,2676,614,2059,0.229,4488,0.596,439,0.661,6.8,3428,1027,2397,0.3,6070,0.565,489,0.614,7.1,2024-25,Rebounding
1610612746,LAC,LA Clippers,82,50,32,18790.0,841,492,342,0.585,1886,0.446,57,0.46,7.1,2750,718,2016,0.261,4405,0.624,393,0.685,6.4,3591,1210,2358,0.337,6111,0.588,450,0.634,6.6,2024-25,Rebounding
1610612747,LAL,Los Angeles Lakers,82,50,32,18546.0,792,434,351,0.548,1846,0.429,74,0.447,8.2,2687,703,1974,0.262,4430,0.607,402,0.667,6.6,3479,1137,2325,0.327,6116,0.569,476,0.617,7.0,2024-25,Rebounding
1610612763,MEM,Memphis Grizzlies,81,48,33,18678.0,1037,558,474,0.538,2419,0.429,108,0.449,7.7,2778,563,2209,0.203,4753,0.584,468,0.648,6.6,3815,1121,2683,0.294,6980,0.547,576,0.596,6.9,2024-25,Rebounding
1610612748,MIA,Miami Heat,82,37,45,19059.0,798,434,361,0.544,1842,0.433,82,0.453,7.9,2760,671,2079,0.243,4486,0.615,449,0.684,6.6,3558,1105,2440,0.311,6182,0.576,531,0.63,6.9,2024-25,Rebounding
1610612749,MIL,Milwaukee Bucks,82,48,34,18769.0,674,393,278,0.583,1530,0.441,39,0.452,8.0,2882,645,2228,0.224,4542,0.635,400,0.696,6.2,3556,1038,2506,0.292,5885,0.604,439,0.653,6.6,2024-25,Rebounding
1610612750,MIN,Minnesota Timberwolves,82,49,33,18809.0,908,509,392,0.561,2095,0.433,64,0.447,7.9,2726,660,2057,0.242,4475,0.609,438,0.675,6.3,3634,1169,2449,0.322,6372,0.57,502,0.619,6.7,2024-25,Rebounding
1610612740,NOP,New Orleans Pelicans,82,21,61,19021.0,993,548,438,0.552,2261,0.439,65,0.452,7.6,2582,591,1979,0.229,4411,0.585,429,0.648,6.5,3575,1139,2417,0.319,6485,0.551,494,0.597,6.8,2024-25,Rebounding
1610612752,NYK,New York Knicks,81,50,31,18642.0,882,501,378,0.568,2003,0.44,58,0.453,7.6,2580,708,1860,0.274,4229,0.61,398,0.673,6.4,3462,1209,2238,0.349,6081,0.569,456,0.615,6.7,2024-25,Rebounding
1610612760,OKC,Oklahoma City Thunder,82,68,14,18891.0,871,453,416,0.52,2201,0.396,84,0.411,9.2,2799,763,2020,0.273,4734,0.591,463,0.655,6.6,3670,1216,2436,0.331,6739,0.545,547,0.593,7.2,2024-25,Rebounding
1610612753,ORL,Orlando Magic,82,41,41,18613.0,914,510,401,0.558,2136,0.428,76,0.444,7.8,2517,612,1894,0.243,4157,0.605,423,0.674,6.5,3431,1122,2295,0.327,6122,0.56,499,0.61,6.9,2024-25,Rebounding
1610612755,PHI,Philadelphia 76ers,82,24,58,18795.0,852,482,371,0.566,1985,0.429,59,0.442,7.8,2410,572,1827,0.237,4172,0.578,386,0.637,6.5,3262,1054,2198,0.323,5982,0.545,445,0.589,6.9,2024-25,Rebounding
1610612756,PHX,Phoenix Suns,82,36,46,18955.0,783,383,399,0.489,1812,0.432,53,0.445,8.9,2701,658,2031,0.244,4368,0.618,381,0.677,6.6,3484,1041,2430,0.299,6015,0.579,434,0.624,7.1,2024-25,Rebounding
1610612757,POR,Portland Trail Blazers,82,36,46,19117.0,1095,647,442,0.591,2482,0.441,91,0.458,7.2,2575,616,1941,0.239,4353,0.592,387,0.649,6.5,3670,1263,2383,0.344,6659,0.551,478,0.594,6.7,2024-25,Rebounding
1610612758,SAC,Sacramento Kings,82,40,42,18806.0,901,510,390,0.566,2048,0.44,63,0.454,7.7,2723,647,2066,0.238,4358,0.625,427,0.693,6.2,3624,1157,2456,0.319,6224,0.582,490,0.632,6.6,2024-25,Rebounding
1610612759,SAS,San Antonio Spurs,82,34,48,18693.0,896,484,406,0.54,1923,0.466,59,0.481,8.4,2685,677,1999,0.252,4489,0.598,465,0.667,6.4,3581,1161,2405,0.324,6260,0.572,524,0.624,6.9,2024-25,Rebounding
1610612761,TOR,Toronto Raptors,82,30,52,18705.0,1034,581,450,0.562,2363,0.438,83,0.454,7.7,2665,606,2048,0.227,4408,0.605,414,0.667,6.7,3699,1187,2498,0.321,6560,0.564,497,0.61,7.0,2024-25,Rebounding
1610612762,UTA,Utah Jazz,82,17,65,19043.0,982,566,416,0.576,2265,0.434,56,0.445,7.9,2741,630,2096,0.23,4540,0.604,448,0.67,6.6,3723,1196,2512,0.321,6605,0.564,504,0.61,6.9,2024-25,Rebounding
1610612764,WAS,Washington Wizards,82,18,64,19072.0,867,500,363,0.577,2008,0.432,49,0.443,7.6,2716,641,2065,0.236,4537,0.599,426,0.661,6.4,3583,1141,2428,0.318,6382,0.561,475,0.607,6.7,2024-25,Rebounding
